"Name","K","Kin","Kout","TypeI","TypeII"
"ACAT2",12,9,3,0,1
"ABCA1",4,3,1,0,1
"BRIX1",20,13,7,0,1
"ETFB",7,4,3,0,1
"ACAN",6,5,1,0,1
"ATP5O",31,11,20,0,1
"CCL21",8,3,5,0,1
"ACTA1",6,4,2,0,1
"ACTB",65,35,30,0,1
"CETN2",11,7,4,0,1
"CHEK1",106,95,11,0,1
"ITGA6",14,12,2,0,1
"PTGS2",18,7,11,0,1
"PTPRC",45,37,8,0,1
"TLR4",48,28,20,0,1
"TNF",46,38,8,0,1
"UBC",70,63,7,0,1
"H2AFV",29,16,13,0,1
"SH3PXD2A",3,2,1,0,1
"ADAMTS15",12,6,6,0,1
"ADAMTSL3",10,5,5,0,1
"THSD7B",3,1,2,0,1
"ADCY4",8,2,6,0,1
"GNAS",5,3,2,0,1
"ADCY8",3,1,2,0,1
"ALDH1A1",4,2,2,0,1
"ARRB2",23,19,4,0,1
"AGO4",10,4,6,0,1
"GPX3",11,8,3,0,1
"TEK",17,16,1,0,1
"ANK2",13,9,4,0,1
"CDK1",178,149,29,0,1
"CENPF",109,69,40,0,1
"DTL",94,60,34,0,1
"EXO1",106,68,38,0,1
"HMMR",87,73,14,0,1
"KIF20A",117,97,20,0,1
"PTTG1",92,79,13,0,1
"ANPEP",12,5,7,0,1
"GGT5",6,5,1,0,1
"SFN",12,8,4,0,1
"AP3S1",3,1,2,0,1
"LRP5",7,2,5,0,1
"MAPRE1",16,11,5,0,1
"RAC1",47,23,24,0,1
"BMP1",7,3,4,0,1
"PPARGC1A",7,3,4,0,1
"PRKACA",19,11,8,0,1
"REN",3,1,2,0,1
"SCNN1G",4,2,2,0,1
"NAPA",9,5,4,0,1
"FCGR2A",26,5,21,0,1
"FCGR3A",36,22,14,0,1
"PCNA",94,73,21,0,1
"POLA1",57,42,15,0,1
"RAD51",84,66,18,0,1
"RFC4",101,82,19,0,1
"ATP10A",3,1,2,0,1
"ATP6AP2",11,8,3,0,1
"UQCRQ",38,26,12,0,1
"BUB3",35,25,10,0,1
"GMNN",44,8,36,0,1
"BRCA2",43,28,15,0,1
"CENPW",42,27,15,0,1
"SDC1",11,8,3,0,1
"MUC1",10,9,1,0,1
"BANF1",9,3,6,0,1
"PPP2R1A",24,10,14,0,1
"SNRPD2",41,25,16,0,1
"BAX",13,4,9,0,1
"MRPS12",30,18,12,0,1
"NTRK3",4,3,1,0,1
"NFASC",8,2,6,0,1
"CAV1",25,6,19,0,1
"PTPN22",5,2,3,0,1
"SYK",36,22,14,0,1
"COL7A1",5,3,2,0,1
"FN1",56,30,26,0,1
"KDELR1",8,6,2,0,1
"FUNDC1",3,2,1,0,1
"POLR2K",12,10,2,0,1
"POLR3K",7,4,3,0,1
"EIF6",27,17,10,0,1
"BUD31",16,13,3,0,1
"SNRPB",35,28,7,0,1
"MRPL17",21,7,14,0,1
"MS4A6A",9,8,1,0,1
"CFH",12,6,6,0,1
"DLGAP3",6,2,4,0,1
"C3orf58",5,3,2,0,1
"GAD1",11,6,5,0,1
"KCNQ2",10,6,4,0,1
"CALR",10,6,4,0,1
"PRKCSH",3,2,1,0,1
"CANX",15,1,14,0,1
"VDAC1",15,3,12,0,1
"DUOX1",5,3,2,0,1
"NTRK1",9,8,1,0,1
"CXCL10",28,10,18,0,1
"CXCL9",18,11,7,0,1
"CSF1",13,4,9,0,1
"CDH2",5,2,3,0,1
"CCND3",12,7,5,0,1
"S100A9",8,5,3,0,1
"CD300C",9,6,3,0,1
"MET",13,8,5,0,1
"IGF1",22,11,11,0,1
"TUBA1A",15,6,9,0,1
"TUBA1B",10,6,4,0,1
"TLL2",4,2,2,0,1
"CHRNA3",3,1,2,0,1
"FCGR2B",20,9,11,0,1
"DNM1",7,3,4,0,1
"COX17",10,2,8,0,1
"SPTBN1",5,3,2,0,1
"P4HA2",8,7,1,0,1
"COLGALT2",3,2,1,0,1
"P4HA1",11,3,8,0,1
"VWF",10,1,9,0,1
"FMOD",9,7,2,0,1
"COX8A",17,8,9,0,1
"FCN2",2,1,1,0,1
"FCER1G",23,3,20,0,1
"CTNNBL1",8,5,3,0,1
"SEC61G",22,14,8,0,1
"CYP11B2",5,1,4,0,1
"CYP17A1",4,1,3,0,1
"DBH",3,2,1,0,1
"DRD1",2,1,1,0,1
"DCK",7,1,6,0,1
"USH1G",2,1,1,0,1
"DLG3",7,2,5,0,1
"JAG2",3,2,1,0,1
"LHX6",3,2,1,0,1
"GIPC1",5,2,3,0,1
"TCEB2",6,1,5,0,1
"LAMTOR4",5,1,4,0,1
"MTPN",3,2,1,0,1
"GJA1",7,1,6,0,1
"TIMM17B",4,2,2,0,1
"NEGR1",3,2,1,0,1
"SNRPD1",31,13,18,0,1
"PLA2G4A",10,4,6,0,1
"TMX4",2,1,1,0,1
"WNT3A",7,3,4,0,1
"FLNC",4,1,3,0,1
"PNISR",9,4,5,0,1
"SRSF11",5,3,2,0,1
"WNT2B",5,2,3,0,1
"GABRA5",4,3,1,0,1
"GADD45GIP1",8,3,5,0,1
"HPRT1",5,2,3,0,1
"GATA2",3,1,2,0,1
"WIF1",2,1,1,0,1
"GLDN",2,1,1,0,1
"GM2A",2,1,1,0,1
"GNA15",12,2,10,0,1
"MGST1",4,1,3,0,1
"GRIN2C",8,5,3,0,1
"GRIN2D",8,1,7,0,1
"LCN2",3,2,1,0,1
"HK2",4,1,3,0,1
"OPHN1",4,2,2,0,1
"HOXA5",5,1,4,0,1
"HSPB2",2,1,1,0,1
"RPL35",31,2,29,0,1
"TAC1",6,3,3,0,1
"KCND2",3,1,2,0,1
"PHGDH",7,4,3,0,1
"MAB21L1",2,1,1,0,1
"SOCS3",10,3,7,0,1
"NLRC4",7,6,1,0,1
"PLXNB1",7,4,3,0,1
"USP5",4,1,3,0,1
"NLRP3",10,2,8,0,1
"NGFRAP1",3,1,2,0,1
"PCSK2",2,1,1,0,1
"PLCB2",9,1,8,0,1
"PLIN4",2,1,1,0,1
"VIPR1",4,2,2,0,1
"RAMP3",2,1,1,0,1
"RND1",4,1,3,0,1
"SCNN1A",3,1,2,0,1
"TBX18",4,3,1,0,1
"UCHL1",3,1,2,0,1
