"Name","K","Kin","Kout","TypeI","TypeII"
"A2M",27,16,11,0,1
"B2M",79,75,4,0,1
"CTSB",26,9,17,0,1
"HP",24,11,13,0,1
"HSPA5",71,35,36,0,1
"MMP9",68,46,22,0,1
"NGF",37,21,16,0,1
"TGFB2",13,9,4,0,1
"AACS",7,2,5,0,1
"CDC42",162,126,36,0,1
"HELZ2",22,19,3,0,1
"ATP1A2",9,4,5,0,1
"ATP1B1",11,5,6,0,1
"CLU",29,13,16,0,1
"ABCE1",97,25,72,0,1
"ISCU",6,4,2,0,1
"NUBP1",7,2,5,0,1
"ALB",79,34,45,0,1
"SLCO2B1",3,1,2,0,1
"GDAP1",11,2,9,0,1
"ACTB",182,105,77,0,1
"BRIX1",52,23,29,0,1
"FLNA",55,34,21,0,1
"GNB2L1",136,115,21,0,1
"KARS",26,13,13,0,1
"RPS15A",124,38,86,0,1
"RUVBL1",79,31,48,0,1
"UBA52",234,173,61,0,1
"NRAS",99,57,42,0,1
"BAIAP2",27,9,18,0,1
"RAC1",174,90,84,0,1
"RHOA",189,158,31,0,1
"SLC4A1",7,2,5,0,1
"SCD",12,10,2,0,1
"SUCLG2",21,18,3,0,1
"ADHFE1",14,10,4,0,1
"ACBD3",7,4,3,0,1
"DPP4",22,12,10,0,1
"NOS3",46,18,28,0,1
"TNF",153,130,23,0,1
"GBA2",15,13,2,0,1
"HSPG2",56,40,16,0,1
"CXCL11",22,9,13,0,1
"EGFR",93,29,64,0,1
"ACLY",16,3,13,0,1
"GOT1",30,11,19,0,1
"ALDH1A1",17,7,10,0,1
"ALDH2",21,3,18,0,1
"ACOT7",3,2,1,0,1
"PFKP",13,9,4,0,1
"THEM5",3,2,1,0,1
"LPL",19,11,8,0,1
"MGLL",15,5,10,0,1
"ITGB1",144,110,34,0,1
"TNNC2",25,15,10,0,1
"VEGFA",81,80,1,0,1
"WAS",55,32,23,0,1
"BDNF",50,45,5,0,1
"CASP8",63,36,27,0,1
"CETN2",20,13,7,0,1
"CTNNA2",14,11,3,0,1
"DLG4",137,102,35,0,1
"ITGA6",47,39,8,0,1
"ITSN1",24,17,7,0,1
"MAP2",17,10,7,0,1
"PGK1",15,8,7,0,1
"RDX",15,8,7,0,1
"BANF1",14,5,9,0,1
"H2AFZ",91,25,66,0,1
"ACTR1B",14,3,11,0,1
"DCTN1",46,23,23,0,1
"DNALI1",13,4,9,0,1
"DYNC1H1",37,21,16,0,1
"FCGR1A",42,23,19,0,1
"FCGR3A",68,38,30,0,1
"BMPR1A",17,12,5,0,1
"LEFTY1",4,2,2,0,1
"APH1A",20,16,4,0,1
"CD9",27,16,11,0,1
"CDH2",36,12,24,0,1
"CTNNA1",56,27,29,0,1
"CTNNB1",204,116,88,0,1
"EFNA3",10,5,5,0,1
"NCSTN",23,8,15,0,1
"CD163",41,22,19,0,1
"ADAMTSL5",19,9,10,0,1
"CAMK2A",67,52,15,0,1
"CAMK2D",51,26,25,0,1
"GNAI1",75,37,38,0,1
"GNAI3",74,47,27,0,1
"GNAL",22,9,13,0,1
"PDE1A",17,14,3,0,1
"PRKAR1B",23,19,4,0,1
"PRKCE",50,19,31,0,1
"CHEK2",74,59,15,0,1
"ADCY2",32,19,13,0,1
"MTPN",8,7,1,0,1
"ADH1B",13,5,8,0,1
"ALDH1A3",10,6,4,0,1
"CYP2E1",17,15,2,0,1
"ENO2",29,24,5,0,1
"ALDOB",13,6,7,0,1
"HK1",26,21,5,0,1
"PGM2",29,20,9,0,1
"SNTB1",7,4,3,0,1
"SFTPC",10,4,6,0,1
"GIT1",27,22,5,0,1
"PIK3CG",35,15,20,0,1
"F2R",29,13,16,0,1
"HDAC1",129,93,36,0,1
"NLK",10,9,1,0,1
"AGPAT4",17,9,8,0,1
"AGPAT5",13,1,12,0,1
"CDS1",20,6,14,0,1
"NPHP4",12,4,8,0,1
"S100A10",13,9,4,0,1
"CAV1",65,32,33,0,1
"RB1",51,15,36,0,1
"CYP1A1",18,14,4,0,1
"DDX58",66,50,16,0,1
"AIMP1",17,14,3,0,1
"LATS2",14,10,4,0,1
"RRM1",78,31,47,0,1
"AKAP6",13,2,11,0,1
"RYR1",41,21,20,0,1
"RYR2",28,15,13,0,1
"AKR1B1",19,8,11,0,1
"HK2",26,7,19,0,1
"HK3",19,7,12,0,1
"AKR1C2",3,1,2,0,1
"CASP3",84,38,46,0,1
"GNRH1",7,4,3,0,1
"MAP2K4",33,30,3,0,1
"MAPK11",78,38,40,0,1
"PDPK1",33,18,15,0,1
"PRKCZ",28,20,8,0,1
"CYP3A4",12,4,8,0,1
"ITGAX",74,72,2,0,1
"LAMP1",23,13,10,0,1
"MGEA5",9,6,3,0,1
"NPHS1",12,6,6,0,1
"POMC",39,33,6,0,1
"HSD17B6",7,6,1,0,1
"COMT",11,5,6,0,1
"GAD1",41,23,18,0,1
"UPB1",10,3,7,0,1
"INPP5A",11,7,4,0,1
"ALG1",10,2,8,0,1
"ALG8",11,5,6,0,1
"ALKBH6",2,1,1,0,1
"CYP2U1",10,3,7,0,1
"ALOX5",17,10,7,0,1
"EEA1",15,6,9,0,1
"AMFR",15,6,9,0,1
"CD3D",44,11,33,0,1
"HTT",44,28,16,0,1
"LILRB2",35,24,11,0,1
"KCNB1",22,15,7,0,1
"CANT1",20,7,13,0,1
"CNTNAP2",16,7,9,0,1
"GAD2",46,33,13,0,1
"SGIP1",12,5,7,0,1
"SNX2",14,13,1,0,1
"SYNJ1",39,33,6,0,1
"GART",53,34,19,0,1
"RNF2",43,23,20,0,1
"ANG",8,5,3,0,1
"ANXA2",26,15,11,0,1
"EPB41L3",12,5,7,0,1
"ITPR1",54,15,39,0,1
"ITPR3",24,16,8,0,1
"SCN2A",29,16,13,0,1
"SCN8A",21,9,12,0,1
"SCN1A",23,4,19,0,1
"TAGAP",2,1,1,0,1
"KMT2D",15,5,10,0,1
"TCAP",22,6,16,0,1
"ANKRD23",3,1,2,0,1
"MYPN",5,2,3,0,1
"IFT52",13,8,5,0,1
"ANO5",3,1,2,0,1
"ANO6",4,3,1,0,1
"ANPEP",21,7,14,0,1
"CD7",20,11,9,0,1
"GGT5",19,12,7,0,1
"TM4SF1",3,1,2,0,1
"S100A4",7,5,2,0,1
"GPNMB",8,5,3,0,1
"DNAJC6",18,10,8,0,1
"CASK",47,34,13,0,1
"DLG2",45,24,21,0,1
"DLG3",51,27,24,0,1
"GRIN1",65,36,29,0,1
"NRXN1",36,29,7,0,1
"PPFIA3",27,16,11,0,1
"SYN1",44,13,31,0,1
"SYN3",18,12,6,0,1
"ITGB2",89,70,19,0,1
"BUB1",166,64,102,0,1
"DVL1",48,36,12,0,1
"MAPRE1",24,17,7,0,1
"ERCC4",54,21,33,0,1
"EXO1",138,83,55,0,1
"HMGB2",10,3,7,0,1
"NME1",21,11,10,0,1
"NPM1",41,15,26,0,1
"PCNA",128,98,30,0,1
"P4HB",48,26,22,0,1
"SNCA",47,20,27,0,1
"APOBEC3C",2,1,1,0,1
"TRIM5",15,10,5,0,1
"CISH",16,15,1,0,1
"BGN",35,16,19,0,1
"MAPT",38,22,16,0,1
"PLAUR",29,14,15,0,1
"PLIN1",11,3,8,0,1
"FOXO1",29,11,18,0,1
"HNRNPK",47,34,13,0,1
"PPP1CB",50,37,13,0,1
"PPP1CC",68,35,33,0,1
"KDELR1",24,15,9,0,1
"SURF4",23,18,5,0,1
"ARF6",61,21,40,0,1
"FN1",128,75,53,0,1
"SLC2A4",20,12,8,0,1
"ASPM",133,86,47,0,1
"CDCA8",137,99,38,0,1
"CENPF",118,72,46,0,1
"TTK",136,91,45,0,1
"ARHGAP21",5,3,2,0,1
"ITGA1",57,14,43,0,1
"LAMA3",35,19,16,0,1
"MRAS",14,3,11,0,1
"PAK1",63,15,48,0,1
"GABRA1",24,20,4,0,1
"CD3G",40,36,4,0,1
"SUMF2",7,4,3,0,1
"AURKB",159,74,85,0,1
"CCNA2",182,54,128,0,1
"CDT1",84,35,49,0,1
"CENPA",126,58,68,0,1
"CHAF1A",27,13,14,0,1
"MCM7",102,49,53,0,1
"UBE2C",128,74,54,0,1
"PICK1",28,21,7,0,1
"ASPDH",6,3,3,0,1
"ASRGL1",10,7,3,0,1
"DMBT1",6,3,3,0,1
"NAT8L",9,7,2,0,1
"ASPHD1",7,2,5,0,1
"CKS2",65,48,17,0,1
"KIF20B",44,29,15,0,1
"STIL",33,22,11,0,1
"MAD2L1",141,47,94,0,1
"BLM",78,38,40,0,1
"JUN",77,30,47,0,1
"SNRPN",40,29,11,0,1
"MT-ATP6",19,7,12,0,1
"MT-ATP8",19,16,3,0,1
"ATXN7L3",7,6,1,0,1
"CDC25C",87,39,48,0,1
"NCAPD2",58,35,23,0,1
"NDEL1",16,6,10,0,1
"PLK1",144,46,98,0,1
"PRIM1",75,46,29,0,1
"TYMS",107,53,54,0,1
"UBE2S",38,7,31,0,1
"CASC5",61,32,29,0,1
"ERCC6L",32,17,15,0,1
"PPP1CA",65,29,36,0,1
"AZIN2",5,1,4,0,1
"B4GALT1",17,15,2,0,1
"MUC6",17,11,6,0,1
"B4GALT6",9,2,7,0,1
"DIAPH3",21,16,5,0,1
"EPS8",10,2,8,0,1
"CDK2",103,32,71,0,1
"HIST2H2AC",59,23,36,0,1
"TIPIN",53,14,39,0,1
"NTRK3",19,9,10,0,1
"BCAN",23,10,13,0,1
"GPC4",22,15,7,0,1
"PTPRZ1",10,7,3,0,1
"SDC3",28,12,16,0,1
"BCL10",18,12,6,0,1
"CARD11",20,14,6,0,1
"SYK",109,67,42,0,1
"TBR1",9,5,4,0,1
"BCR",21,8,13,0,1
"BEGAIN",4,3,1,0,1
"SEC22A",12,7,5,0,1
"SNAP23",35,6,29,0,1
"COL5A1",36,28,8,0,1
"MADD",17,8,9,0,1
"CD79B",25,13,12,0,1
"GRAP2",34,15,19,0,1
"LCK",96,42,54,0,1
"BNIP2",4,1,3,0,1
"NSUN6",19,13,6,0,1
"RCL1",48,33,15,0,1
"HOMER1",24,8,16,0,1
"UNC13A",22,21,1,0,1
"HLA-C",60,42,18,0,1
"HLA-E",58,39,19,0,1
"HLA-F",47,10,37,0,1
"PABPC1",52,11,41,0,1
"PPL",10,6,4,0,1
"CRY2",14,12,2,0,1
"ESCO2",61,27,34,0,1
"EXOSC8",10,9,1,0,1
"GNL3L",49,19,30,0,1
"PNO1",79,11,68,0,1
"RPP25",40,12,28,0,1
"SF3A3",39,25,14,0,1
"YRDC",7,6,1,0,1
"C1GALT1C1",13,5,8,0,1
"MUCL1",9,3,6,0,1
"C1QB",29,14,15,0,1
"CTSS",31,15,16,0,1
"CHCHD2",8,5,3,0,1
"PTPN22",25,9,16,0,1
"TTBK1",3,1,2,0,1
"DLGAP3",20,8,12,0,1
"ERC2",10,3,7,0,1
"CA4",2,1,1,0,1
"HPGDS",23,5,18,0,1
"PPP1R26",3,2,1,0,1
"CACNA2D1",22,8,14,0,1
"CALM1",65,28,37,0,1
"CALM3",63,18,45,0,1
"KCND3",18,7,11,0,1
"HTR3A",15,8,7,0,1
"SYNGAP1",25,21,4,0,1
"GRIA2",63,16,47,0,1
"CADPS",5,3,2,0,1
"NPY",30,27,3,0,1
"SST",28,9,19,0,1
"CALD1",17,10,7,0,1
"PDIA6",20,15,5,0,1
"SYNCRIP",40,22,18,0,1
"PTK2B",57,42,15,0,1
"CAMK4",12,3,9,0,1
"CAMP",8,3,5,0,1
"PPIB",25,10,15,0,1
"RHO",21,11,10,0,1
"CRIP1",3,1,2,0,1
"MC4R",9,5,4,0,1
"NLGN4X",15,10,5,0,1
"EIF4A1",74,13,61,0,1
"LDB3",19,11,8,0,1
"GRB7",10,7,3,0,1
"IRAK1",47,29,18,0,1
"TGFBR2",20,13,7,0,1
"CBFA2T3",5,2,3,0,1
"LRRTM1",8,3,5,0,1
"DSEL",6,3,3,0,1
"CCDC108",4,1,3,0,1
"CFAP69",7,3,4,0,1
"CCDC114",18,4,14,0,1
"CFAP45",3,2,1,0,1
"DNAAF1",13,7,6,0,1
"DYX1C1",13,5,8,0,1
"DGKQ",9,3,6,0,1
"GBA",22,8,14,0,1
"HIP1R",13,1,12,0,1
"SF3B3",43,17,26,0,1
"CXCR3",43,28,15,0,1
"CCL20",30,19,11,0,1
"ICAM1",57,15,42,0,1
"PF4",23,10,13,0,1
"COL1A2",54,23,31,0,1
"CDK4",47,10,37,0,1
"CDK6",29,7,22,0,1
"HIST1H2AD",26,5,21,0,1
"NUP160",40,27,13,0,1
"SMC1A",35,17,18,0,1
"MAPK3",156,30,126,0,1
"CCNJL",5,2,3,0,1
"CD86",73,32,41,0,1
"CD28",66,22,44,0,1
"EEF1G",91,26,65,0,1
"TRAF3IP3",5,3,2,0,1
"TOLLIP",14,8,6,0,1
"CD1C",25,11,14,0,1
"CD209",17,7,10,0,1
"CD3E",47,21,26,0,1
"CD1E",11,6,5,0,1
"CD79A",33,3,30,0,1
"NOX5",5,3,2,0,1
"HLA-DRB1",52,23,29,0,1
"PDCD1",26,10,16,0,1
"TREML1",7,5,2,0,1
"RGS1",19,8,11,0,1
"CD80",73,9,64,0,1
"CSF1R",54,12,42,0,1
"HLA-DQA1",34,9,25,0,1
"ITGA2",54,17,37,0,1
"LGMN",17,12,5,0,1
"ITGA5",55,14,41,0,1
"SH2D1B",7,4,3,0,1
"TXLNB",2,1,1,0,1
"COL3A1",44,21,23,0,1
"ERBB2",56,7,49,0,1
"DLGAP1",22,6,16,0,1
"THADA",7,4,3,0,1
"CDKL1",2,1,1,0,1
"CDKL5",10,6,4,0,1
"LEF1",31,2,29,0,1
"CEL",12,10,2,0,1
"EFNA2",9,2,7,0,1
"MPHOSPH8",7,3,4,0,1
"MVB12A",8,5,3,0,1
"ELOVL4",6,3,3,0,1
"CFAP221",9,5,4,0,1
"ERLIN2",7,2,5,0,1
"F11R",17,7,10,0,1
"CH25H",5,4,1,0,1
"SYP",37,10,27,0,1
"SYT2",20,13,7,0,1
"CHID1",3,2,1,0,1
"CRCP",18,13,5,0,1
"TLL2",18,11,7,0,1
"TWSG1",4,2,2,0,1
"CHRM1",27,12,15,0,1
"CHRNA2",6,5,1,0,1
"CHRNA3",7,2,5,0,1
"FMOD",10,6,4,0,1
"CIDEA",4,2,2,0,1
"CMTM7",5,3,2,0,1
"MB",6,5,1,0,1
"KLC2",18,13,5,0,1
"KCNQ5",18,8,10,0,1
"CNGB1",9,1,8,0,1
"CNNM2",2,1,1,0,1
"CNTN4",2,1,1,0,1
"NF2",16,9,7,0,1
"KIAA0319",4,2,2,0,1
"CRTAP",22,11,11,0,1
"ITGAV",88,12,76,0,1
"LUM",29,7,22,0,1
"SPP1",35,20,15,0,1
"COMMD6",3,1,2,0,1
"DISC1",16,10,6,0,1
"CORT",4,3,1,0,1
"CP",10,4,6,0,1
"XRN2",33,24,9,0,1
"TAC1",19,6,13,0,1
"ELMO1",17,7,10,0,1
"MAPK10",42,21,21,0,1
"RET",14,8,6,0,1
"LSM5",36,31,5,0,1
"CRTC1",5,3,2,0,1
"CSTA",8,1,7,0,1
"SRSF3",36,25,11,0,1
"PKP4",9,5,4,0,1
"PROM1",11,6,5,0,1
"VAV3",24,13,11,0,1
"GNS",10,3,7,0,1
"CYP11A1",12,1,11,0,1
"LHCGR",4,3,1,0,1
"PTGS1",19,5,14,0,1
"KRTCAP2",14,3,11,0,1
"SEC61G",72,44,28,0,1
"FAAH2",4,3,1,0,1
"GRM5",34,8,26,0,1
"MFAP2",10,7,3,0,1
"E2F1",36,8,28,0,1
"SIN3B",20,14,6,0,1
"DHX9",52,26,26,0,1
"LSM8",34,7,27,0,1
"RIC3",5,2,3,0,1
"DENND2D",4,1,3,0,1
"ULK1",12,4,8,0,1
"SHH",36,17,19,0,1
"PLCB1",38,17,21,0,1
"PLCB4",26,18,8,0,1
"DHX40",2,1,1,0,1
"KCNA4",21,8,13,0,1
"LHX6",6,3,3,0,1
"SFTPD",8,3,5,0,1
"HSPA13",19,5,14,0,1
"GFRA1",4,2,2,0,1
"DOK6",4,3,1,0,1
"RIT2",4,2,2,0,1
"PLXNA2",12,7,5,0,1
"DRP2",3,1,2,0,1
"PKP3",8,5,3,0,1
"PLEC",37,9,28,0,1
"DTNB",7,3,4,0,1
"DUSP9",6,3,3,0,1
"SPRY4",5,3,2,0,1
"TUBB",16,8,8,0,1
"TFDP1",25,8,17,0,1
"SLC3A2",12,7,5,0,1
"STAT1",78,14,64,0,1
"TCF12",10,8,2,0,1
"POU3F2",7,4,3,0,1
"EIF4EBP1",11,5,6,0,1
"SNRPD1",79,26,53,0,1
"EMC10",5,4,1,0,1
"MMGT1",4,3,1,0,1
"NR4A2",6,3,3,0,1
"SPINT2",6,3,3,0,1
"FGFR3",19,9,10,0,1
"RNASE2",7,3,4,0,1
"ETS2",8,4,4,0,1
"GATA3",19,11,8,0,1
"RAB8A",34,13,21,0,1
"FOXM1",46,5,41,0,1
"ZNF217",3,2,1,0,1
"FAIM2",8,4,4,0,1
"FAM172A",2,1,1,0,1
"SOWAHB",2,1,1,0,1
"GOLGA7B",5,4,1,0,1
"FAM46A",2,1,1,0,1
"FAM83H",4,1,3,0,1
"PLAU",20,13,7,0,1
"SIRPA",17,12,5,0,1
"MNDA",11,8,3,0,1
"PIGO",11,7,4,0,1
"NRP2",19,9,10,0,1
"TAGLN3",4,1,3,0,1
"KY",5,2,3,0,1
"UNC5A",7,3,4,0,1
"NES",11,6,5,0,1
"SOX10",9,4,5,0,1
"FOXP2",4,3,1,0,1
"FPGT",4,3,1,0,1
"GABBR1",20,13,7,0,1
"GABRA5",16,8,8,0,1
"MANEA",2,1,1,0,1
"GIMAP8",4,2,2,0,1
"PANX2",5,4,1,0,1
"PIP4K2A",15,8,7,0,1
"SAT1",7,4,3,0,1
"NTNG2",8,6,2,0,1
"GUSB",10,3,7,0,1
"SPRTN",11,4,7,0,1
"IMMP2L",3,1,2,0,1
"POLR2L",39,13,26,0,1
"GYG1",10,5,5,0,1
"SAP30",21,3,18,0,1
"TNPO1",23,8,15,0,1
"TM6SF2",3,2,1,0,1
"HOXA5",16,2,14,0,1
"MEIS1",12,4,8,0,1
"OPALIN",6,3,3,0,1
"ID3",3,2,1,0,1
"IGF2BP1",4,1,3,0,1
"NIPA2",5,3,2,0,1
"RAB6B",6,2,4,0,1
"IL17D",2,1,1,0,1
"MAPKAPK2",15,8,7,0,1
"STAM2",10,2,8,0,1
"RAB27A",13,6,7,0,1
"PNPLA7",6,5,1,0,1
"KCNK12",6,2,4,0,1
"NRP1",23,4,19,0,1
"PLXNA1",17,14,3,0,1
"TMA16",33,9,24,0,1
"KNDC1",2,1,1,0,1
"PNISR",9,3,6,0,1
"LGALS3BP",7,3,4,0,1
"MAG",12,7,5,0,1
"PPP1R14C",4,2,2,0,1
"PAFAH2",11,5,6,0,1
"LSM12",7,6,1,0,1
"LSM2",33,25,8,0,1
"LSM3",41,14,27,0,1
"LYZ",2,1,1,0,1
"MGAT5B",2,1,1,0,1
"SLC3A1",5,2,3,0,1
"RRM2B",22,2,20,0,1
"NKX2-5",7,1,6,0,1
"METTL18",3,1,2,0,1
"MOV10L1",5,1,4,0,1
"RPLP2",79,12,67,0,1
"SMPX",4,1,3,0,1
"NAP1L5",4,1,3,0,1
"RBFOX1",7,3,4,0,1
"PMEL",4,3,1,0,1
"SLC1A1",5,3,2,0,1
"RASSF9",2,1,1,0,1
"TRNAU1AP",19,10,9,0,1
"PIP5K1B",22,3,19,0,1
"TMED5",15,13,2,0,1
"PLIN4",2,1,1,0,1
"XXYLT1",2,1,1,0,1
"SYT3",9,5,4,0,1
"PPP2R2C",8,2,6,0,1
"SLC6A1",13,7,6,0,1
"UGP2",14,4,10,0,1
"REXO2",4,1,3,0,1
"RHPN1",6,1,5,0,1
"SRPRB",23,15,8,0,1
"SLC10A7",3,2,1,0,1
"SLC1A2",16,4,12,0,1
"SYCP2",8,3,5,0,1
"SYNPR",7,6,1,0,1
"TAS1R1",3,1,2,0,1
"TRPV3",4,1,3,0,1
