"Name","K","Kin","Kout","TypeI","TypeII"
"SLCO1A2",5,3,2,0,1
"PDZK1",11,9,2,0,1
"AQP4",7,6,1,0,1
"ABCE1",16,6,10,0,1
"BRIX1",28,13,15,0,1
"FLNA",38,26,12,0,1
"WDR43",28,20,8,0,1
"PLN",8,4,4,0,1
"LYPLA1",7,4,3,0,1
"NRAS",51,35,16,0,1
"ACACB",4,2,2,0,1
"PRKAA2",6,5,1,0,1
"ACSL6",5,4,1,0,1
"ACAN",23,22,1,0,1
"DPP4",21,11,10,0,1
"ACER2",9,7,2,0,1
"NTRK1",32,29,3,0,1
"ACTA1",23,12,11,0,1
"LAMB3",30,24,6,0,1
"MYH11",22,13,9,0,1
"TNNC2",11,8,3,0,1
"MYL6",16,14,2,0,1
"GSN",7,5,2,0,1
"TPM1",31,13,18,0,1
"TPM3",25,13,12,0,1
"RB1",44,12,32,0,1
"EGFR",86,17,69,0,1
"ICAM1",39,14,25,0,1
"ITGB6",20,9,11,0,1
"ACTR2",16,11,5,0,1
"ARPC1B",9,7,2,0,1
"ADAM10",17,5,12,0,1
"ADAM17",17,10,7,0,1
"CD34",35,18,17,0,1
"EFNA3",8,6,2,0,1
"JUP",26,23,3,0,1
"NCSTN",9,3,6,0,1
"TNF",101,88,13,0,1
"THBS2",25,15,10,0,1
"COL5A2",19,16,3,0,1
"HLA-C",39,26,13,0,1
"PSMB8",44,28,16,0,1
"CAMK2A",30,22,8,0,1
"PDE3A",8,5,3,0,1
"ADCY4",23,11,12,0,1
"ADCY6",19,8,11,0,1
"GSTA1",15,9,6,0,1
"HPGDS",15,7,8,0,1
"MAOA",9,5,4,0,1
"CXCR4",60,39,21,0,1
"CAV3",15,8,7,0,1
"F2",31,15,16,0,1
"AGFG1",2,1,1,0,1
"SRM",3,2,1,0,1
"LCLAT1",13,6,7,0,1
"AGRN",25,17,8,0,1
"SDC1",37,28,9,0,1
"CAV1",42,21,21,0,1
"HSP90AA1",73,35,38,0,1
"HSP90AB1",33,24,9,0,1
"NCOR2",19,9,10,0,1
"STAT1",48,3,45,0,1
"KRT17",8,6,2,0,1
"AKAP6",6,1,5,0,1
"RYR2",18,9,9,0,1
"ENO2",12,9,3,0,1
"BCL2",16,14,2,0,1
"GSK3B",39,21,18,0,1
"HSP90B1",31,13,18,0,1
"IKBKB",26,24,2,0,1
"ILK",21,16,5,0,1
"MAPK11",37,18,19,0,1
"FGA",22,10,12,0,1
"FGG",21,13,8,0,1
"IGF1",49,25,24,0,1
"PLG",19,11,8,0,1
"ALDH18A1",15,9,6,0,1
"AMT",4,1,3,0,1
"RPN1",21,10,11,0,1
"STT3A",16,14,2,0,1
"ALK",7,4,3,0,1
"WNT7A",21,10,11,0,1
"AMMECR1",4,1,3,0,1
"COL4A5",15,7,8,0,1
"GAS7",3,2,1,0,1
"SGIP1",6,2,4,0,1
"SH3GL2",14,12,2,0,1
"CDC20",149,105,44,0,1
"CDK1",232,186,46,0,1
"NEK2",93,58,35,0,1
"MET",35,15,20,0,1
"IRS1",29,9,20,0,1
"SCN8A",14,7,7,0,1
"SCN3B",15,12,3,0,1
"TCAP",13,5,8,0,1
"ATR",68,36,32,0,1
"ASPM",137,87,50,0,1
"AURKB",153,68,85,0,1
"BUB1",162,61,101,0,1
"BUB1B",147,46,101,0,1
"CCNA2",177,51,126,0,1
"CDCA8",139,102,37,0,1
"KIF15",105,54,51,0,1
"KIF2C",128,92,36,0,1
"KPNA2",59,56,3,0,1
"SH3KBP1",16,12,4,0,1
"SHCBP1",56,26,30,0,1
"TTK",134,89,45,0,1
"TYMS",101,51,50,0,1
"ZWINT",95,68,27,0,1
"DLG4",72,50,22,0,1
"CD5",24,13,11,0,1
"CD7",18,8,10,0,1
"FUT4",18,11,7,0,1
"PTPRC",78,71,7,0,1
"SFN",26,14,12,0,1
"ANXA1",6,5,1,0,1
"CD28",48,21,27,0,1
"DDC",8,5,3,0,1
"FCGR2B",23,15,8,0,1
"ITGAL",26,14,12,0,1
"APLNR",2,1,1,0,1
"BGN",18,10,8,0,1
"CFH",12,8,4,0,1
"TREM2",11,6,5,0,1
"PLAUR",20,12,8,0,1
"NGF",21,11,10,0,1
"CNKSR2",2,1,1,0,1
"GNGT1",20,2,18,0,1
"CDT1",81,37,44,0,1
"FEN1",90,40,50,0,1
"HIST1H3D",35,22,13,0,1
"HIST2H3C",35,17,18,0,1
"PCNA",104,81,23,0,1
"CKS2",64,46,18,0,1
"RBBP8",41,33,8,0,1
"BLM",67,34,33,0,1
"DNA2",48,25,23,0,1
"ATL1",5,1,4,0,1
"FXYD6",5,4,1,0,1
"ORC1",62,44,18,0,1
"TTI1",5,3,2,0,1
"XRCC2",25,13,12,0,1
"CDC25A",54,23,31,0,1
"CKS1B",58,31,27,0,1
"GMNN",53,8,45,0,1
"NCAPD2",56,33,23,0,1
"PRIM1",65,43,22,0,1
"SKA3",46,23,23,0,1
"UBE2S",24,6,18,0,1
"ERCC6L",32,17,15,0,1
"EPS8L3",4,3,1,0,1
"B4GALT1",19,12,7,0,1
"MUC3A",29,14,15,0,1
"MUC17",30,6,24,0,1
"MUCL1",23,6,17,0,1
"HKDC1",14,8,6,0,1
"CASP2",14,4,10,0,1
"HSPA5",50,22,28,0,1
"PIM1",8,7,1,0,1
"CCT5",14,4,10,0,1
"RAB8A",11,4,7,0,1
"SYK",22,17,5,0,1
"BID",12,8,4,0,1
"BEGAIN",3,2,1,0,1
"PRDM8",2,1,1,0,1
"DYNC1I1",11,5,6,0,1
"CASP8",30,15,15,0,1
"CFLAR",12,6,6,0,1
"LTB",10,8,2,0,1
"LCK",59,27,32,0,1
"TNFSF11",19,12,7,0,1
"MAP1LC3A",4,2,2,0,1
"BRINP2",3,1,2,0,1
"FANCM",35,6,29,0,1
"GEN1",27,13,14,0,1
"RMI1",33,11,22,0,1
"NOL12",10,5,5,0,1
"MAPT",24,10,14,0,1
"PDCD1",23,13,10,0,1
"ESCO2",58,26,32,0,1
"C1QC",14,9,5,0,1
"MASP1",7,3,4,0,1
"CYP24A1",5,1,4,0,1
"CACNA1C",33,8,25,0,1
"CACNA1G",13,6,7,0,1
"CACNA1S",13,6,7,0,1
"CALD1",13,4,9,0,1
"MMP9",48,27,21,0,1
"GRIA1",25,20,5,0,1
"GRIN2A",30,17,13,0,1
"CAMK2G",14,4,10,0,1
"DLG2",25,10,15,0,1
"MYO6",13,9,4,0,1
"YWHAB",30,20,10,0,1
"FPR2",6,4,2,0,1
"S100A7",7,6,1,0,1
"CANT1",6,2,4,0,1
"ENTPD8",12,7,5,0,1
"SLC45A3",2,1,1,0,1
"EDEM3",18,9,9,0,1
"EVPL",13,5,8,0,1
"NRXN1",16,12,4,0,1
"PTBP1",15,8,7,0,1
"PTBP2",6,4,2,0,1
"LDB3",21,16,5,0,1
"MYOZ2",12,3,9,0,1
"OCLN",25,13,12,0,1
"CBFA2T3",3,1,2,0,1
"ERBB4",24,8,16,0,1
"LDB2",7,3,4,0,1
"LRRTM1",6,1,5,0,1
"NRXN3",19,18,1,0,1
"CBX3",20,3,17,0,1
"HIST1H2AD",42,16,26,0,1
"DSEL",4,3,1,0,1
"CCDC108",3,1,2,0,1
"CCR8",27,13,14,0,1
"CXCR3",40,22,18,0,1
"COL1A2",31,16,15,0,1
"CSF2",43,14,29,0,1
"CXCL8",54,22,32,0,1
"IL1B",53,14,39,0,1
"LIN9",16,11,5,0,1
"HIST1H2AJ",39,12,27,0,1
"CD163",19,11,8,0,1
"FCGR1A",18,13,5,0,1
"FCGR3A",39,26,13,0,1
"CD3D",30,10,20,0,1
"CD86",45,22,23,0,1
"CD79A",21,2,19,0,1
"CD79B",18,12,6,0,1
"SPN",15,10,5,0,1
"ITGA8",25,14,11,0,1
"TYROBP",35,5,30,0,1
"CD80",57,12,45,0,1
"HLA-DQA1",18,6,12,0,1
"ITGA2",42,14,28,0,1
"CLDN1",6,1,5,0,1
"CLDN4",10,8,2,0,1
"CLDN7",14,7,7,0,1
"F11R",12,6,6,0,1
"GDNF",18,13,5,0,1
"GFRA1",11,4,7,0,1
"PKP3",17,10,7,0,1
"ROBO3",5,3,2,0,1
"PTK6",6,5,1,0,1
"CDSN",9,8,1,0,1
"KLK3",4,2,2,0,1
"ESR1",18,11,7,0,1
"GATA4",21,12,9,0,1
"CENPH",27,7,20,0,1
"LIMK1",13,8,5,0,1
"MARVELD2",9,5,4,0,1
"CLDN12",7,1,6,0,1
"CHL1",8,1,7,0,1
"CHML",10,5,5,0,1
"OPN3",3,2,1,0,1
"KIAA0196",5,2,3,0,1
"RGMB",7,2,5,0,1
"PAK2",39,12,27,0,1
"CKAP4",2,1,1,0,1
"SLC12A5",5,2,3,0,1
"SLC9A3R1",15,2,13,0,1
"CLPB",8,1,7,0,1
"NRM",3,1,2,0,1
"CNGB3",5,1,4,0,1
"CNR2",3,2,1,0,1
"CNTFR",3,2,1,0,1
"COA6",3,2,1,0,1
"TIMM8A",4,3,1,0,1
"COL11A1",17,11,6,0,1
"LUM",25,5,20,0,1
"STX2",7,6,1,0,1
"SNRPG",31,7,24,0,1
"KYNU",5,1,4,0,1
"CSAG1",6,2,4,0,1
"CSE1L",8,2,6,0,1
"MAGI2",5,3,2,0,1
"MED1",12,6,6,0,1
"CTSF",3,1,2,0,1
"GBP1",19,9,10,0,1
"F2R",20,9,11,0,1
"NOX1",7,3,4,0,1
"CYCS",19,5,14,0,1
"MT-CO2",10,6,4,0,1
"CYP17A1",9,5,4,0,1
"INSL3",2,1,1,0,1
"PTGS1",15,6,9,0,1
"PLA2G4E",3,2,1,0,1
"GNL3L",26,11,15,0,1
"DCDC2",3,1,2,0,1
"PNP",10,5,5,0,1
"MAB21L1",5,4,1,0,1
"PIFO",2,1,1,0,1
"IHH",17,5,12,0,1
"PTCH2",9,7,2,0,1
"SHH",26,14,12,0,1
"DLGAP2",9,7,2,0,1
"DMBT1",6,3,3,0,1
"SFTPD",5,2,3,0,1
"SGCE",8,7,1,0,1
"WDR66",5,2,3,0,1
"DNAJB5",4,3,1,0,1
"P2RX6",5,4,1,0,1
"HSPA13",14,4,10,0,1
"PLXNA4",9,6,3,0,1
"PKP1",13,5,8,0,1
"KIF5A",17,11,6,0,1
"PARP9",13,5,8,0,1
"DUOXA2",4,2,2,0,1
"TRRAP",17,9,8,0,1
"IKZF3",8,1,7,0,1
"NEDD4L",12,9,3,0,1
"RRAS",17,3,14,0,1
"SOCS1",14,7,7,0,1
"PRX",4,2,2,0,1
"IRAK1",25,16,9,0,1
"IFIH1",34,8,26,0,1
"FGFR3",16,10,6,0,1
"GPX2",10,6,4,0,1
"IL23R",9,5,4,0,1
"SPRR1B",11,4,7,0,1
"KLKB1",6,1,5,0,1
"RAD54B",16,6,10,0,1
"LIPT2",2,1,1,0,1
"FCER1G",19,3,16,0,1
"PIGR",5,1,4,0,1
"TDP1",11,4,7,0,1
"NRP2",15,9,6,0,1
"STXBP2",7,6,1,0,1
"FLNC",17,6,11,0,1
"STEAP3",5,4,1,0,1
"HNF4A",19,9,10,0,1
"GLB1",17,5,12,0,1
"GABBR1",3,1,2,0,1
"NPY",8,6,2,0,1
"GABRA3",2,1,1,0,1
"TBX18",7,5,2,0,1
"GFI1",5,3,2,0,1
"RAP1A",22,9,13,0,1
"PF4",9,5,4,0,1
"RGS11",6,5,1,0,1
"SV2B",4,3,1,0,1
"NTRK3",9,5,4,0,1
"IRF6",12,2,10,0,1
"TM6SF1",2,1,1,0,1
"TM6SF2",4,3,1,0,1
"KAT2B",16,3,13,0,1
"HIST1H2AI",28,7,21,0,1
"MEIS1",12,3,9,0,1
"HOXB4",10,8,2,0,1
"HSD11B2",3,1,2,0,1
"HS6ST3",3,1,2,0,1
"SEC61G",12,9,3,0,1
"SMPX",8,5,3,0,1
"SAMD9",10,6,4,0,1
"IL27RA",7,4,3,0,1
"IGF2BP1",4,1,3,0,1
"PGR",12,1,11,0,1
"KBTBD12",4,2,2,0,1
"KCNAB1",12,10,2,0,1
"KCNH2",18,2,16,0,1
"KHDRBS3",2,1,1,0,1
"KIF21A",4,3,1,0,1
"KIF3B",6,3,3,0,1
"WNK3",7,2,5,0,1
"KMO",4,2,2,0,1
"SF3B3",17,7,10,0,1
"LACTB2",3,1,2,0,1
"PNISR",7,3,4,0,1
"LGR5",6,2,4,0,1
"SSR3",11,5,6,0,1
"SYNE1",7,4,3,0,1
"PPP1R14C",3,1,2,0,1
"SOST",10,4,6,0,1
"MAP1S",3,1,2,0,1
"NLGN2",14,2,12,0,1
"LSM5",12,9,3,0,1
"LUC7L",13,2,11,0,1
"SNRPD1",25,7,18,0,1
"RASSF1",9,2,7,0,1
"STK4",7,4,3,0,1
"NEFH",8,4,4,0,1
"MCU",4,2,2,0,1
"MEOX2",2,1,1,0,1
"MFSD9",4,1,3,0,1
"PMEL",3,1,2,0,1
"MRPL3",9,3,6,0,1
"MRPL30",6,2,4,0,1
"MUSK",6,3,3,0,1
"NMU",3,1,2,0,1
"RSPO1",4,3,1,0,1
"PLAGL1",4,1,3,0,1
"PHF14",3,2,1,0,1
"POU3F3",2,1,1,0,1
"POU5F1",20,2,18,0,1
"TMPRSS2",4,2,2,0,1
"PTPN3",5,2,3,0,1
"ROM1",3,2,1,0,1
"RANBP1",9,4,5,0,1
"REST",13,1,12,0,1
"RHBDF1",2,1,1,0,1
"RSPO3",5,4,1,0,1
"RSPO2",4,1,3,0,1
"SALL1",3,2,1,0,1
"SCN4B",14,5,9,0,1
"U2AF1L4",8,4,4,0,1
"SNAP25",43,3,40,0,1
"TPD52",3,2,1,0,1
"TCTE3",3,1,2,0,1
"TGS1",12,1,11,0,1
"TREML1",5,3,2,0,1
"UBXN6",3,1,2,0,1
