"Name","K","Kin","Kout","TypeI","TypeII"
"MAOA",27,13,14,0,1
"YWHAZ",58,45,13,0,1
"ABAT",12,9,3,0,1
"CYP7A1",26,11,15,0,1
"SLC51B",4,3,1,0,1
"SLCO1A2",6,4,2,0,1
"ALB",73,28,45,0,1
"NRAS",78,49,29,0,1
"SLC4A1",6,2,4,0,1
"CPT1B",6,3,3,0,1
"ACSBG2",11,10,1,0,1
"AOX1",33,23,10,0,1
"ACAN",35,32,3,0,1
"ACBD3",4,1,3,0,1
"APLNR",3,2,1,0,1
"CHKB",3,2,1,0,1
"COLQ",9,8,1,0,1
"NGF",34,23,11,0,1
"NTRK1",36,30,6,0,1
"CXCL11",28,11,17,0,1
"EGFR",143,37,106,0,1
"AMACR",8,6,2,0,1
"GNPAT",22,16,6,0,1
"IZUMO1",3,1,2,0,1
"ACTA1",35,17,18,0,1
"EZR",34,23,11,0,1
"MYH11",29,19,10,0,1
"TNNC2",21,11,10,0,1
"MYH14",15,14,1,0,1
"DMD",44,20,24,0,1
"MYL4",18,8,10,0,1
"ACTR2",22,13,9,0,1
"ARF1",37,33,4,0,1
"GRB2",101,76,25,0,1
"LRRC61",4,2,2,0,1
"ADAD2",2,1,1,0,1
"ADAT3",2,1,1,0,1
"ADAMTS14",24,19,5,0,1
"ADAMTS3",28,12,16,0,1
"METTL13",6,3,3,0,1
"ADCY2",23,13,10,0,1
"GNAI1",62,33,29,0,1
"ADCY4",27,9,18,0,1
"ADCY8",26,5,21,0,1
"GNAL",20,8,12,0,1
"GNAS",36,20,16,0,1
"GNG2",59,28,31,0,1
"AKAP5",17,7,10,0,1
"CNR1",15,10,5,0,1
"ALDH1A1",25,9,16,0,1
"CYP2E1",35,32,3,0,1
"UGT2B15",17,6,11,0,1
"RARRES2",6,5,1,0,1
"CAV3",36,18,18,0,1
"ADM2",9,7,2,0,1
"DRD2",13,10,3,0,1
"ADRB2",28,8,20,0,1
"GOT1",20,13,7,0,1
"GGCT",10,3,7,0,1
"AGER",8,6,2,0,1
"ITGB2",59,48,11,0,1
"AGMO",8,6,2,0,1
"AGR2",9,6,3,0,1
"SDC1",56,46,10,0,1
"ALAS2",7,3,4,0,1
"GPT",15,10,5,0,1
"UPP1",6,5,1,0,1
"CASP3",67,29,38,0,1
"CYCS",49,16,33,0,1
"XIAP",29,20,9,0,1
"AIM2",10,6,4,0,1
"CARD8",5,3,2,0,1
"NME1",24,12,12,0,1
"RRM1",71,30,41,0,1
"GPER1",6,5,1,0,1
"AKT3",25,4,21,0,1
"FYN",98,50,48,0,1
"GNRH1",16,4,12,0,1
"GSK3B",39,17,22,0,1
"HSP90AA1",126,68,58,0,1
"LCK",75,32,43,0,1
"MAPK11",48,22,26,0,1
"NOS3",35,12,23,0,1
"C4A",21,16,5,0,1
"CAV1",73,33,40,0,1
"CD8A",86,70,16,0,1
"CYP3A4",35,13,22,0,1
"FN1",101,59,42,0,1
"GH1",13,5,8,0,1
"HP",25,14,11,0,1
"IGF1",63,31,32,0,1
"IL6",103,85,18,0,1
"MMP9",51,30,21,0,1
"OCLN",24,11,13,0,1
"PLG",43,21,22,0,1
"RBP4",11,7,4,0,1
"SAA1",17,12,5,0,1
"TLR4",78,51,27,0,1
"CD9",15,12,3,0,1
"CYP4A11",22,6,16,0,1
"SLC1A2",9,3,6,0,1
"AOC3",12,6,6,0,1
"UPB1",10,3,7,0,1
"ALDOB",12,9,3,0,1
"PGK1",16,9,7,0,1
"S100A12",9,5,4,0,1
"CYP2C9",16,5,11,0,1
"PPP1R3D",5,4,1,0,1
"HM13",20,17,3,0,1
"HSPA5",52,28,24,0,1
"AMPH",12,7,5,0,1
"CNTNAP2",8,3,5,0,1
"GLS2",12,5,7,0,1
"TYMS",95,51,44,0,1
"TEK",32,24,8,0,1
"ANGPTL3",6,3,3,0,1
"ANK2",18,9,9,0,1
"RYR2",16,9,7,0,1
"SCN3B",14,9,5,0,1
"SPTBN1",12,5,7,0,1
"ANKRD1",5,3,2,0,1
"CYR61",5,3,2,0,1
"TCAP",27,8,19,0,1
"MYPN",5,2,3,0,1
"AURKB",156,67,89,0,1
"CCNA2",167,45,122,0,1
"CD2AP",19,14,5,0,1
"CDC20",146,103,43,0,1
"CDC25C",77,34,43,0,1
"CDCA8",133,94,39,0,1
"CDK1",222,180,42,0,1
"CENPA",129,59,70,0,1
"DIAPH3",18,15,3,0,1
"INCENP",63,51,12,0,1
"MYL9",29,10,19,0,1
"NEK2",91,55,36,0,1
"RRM2",133,77,56,0,1
"SHCBP1",56,26,30,0,1
"TTK",133,88,45,0,1
"UBE2C",125,71,54,0,1
"ZWINT",95,68,27,0,1
"CD5",29,15,14,0,1
"SFN",23,14,9,0,1
"ANXA1",12,9,3,0,1
"FPR2",8,6,2,0,1
"RDH11",5,4,1,0,1
"APEH",4,1,3,0,1
"NOTCH4",27,19,8,0,1
"BLM",72,32,40,0,1
"CASC5",57,29,28,0,1
"ERCC4",47,14,33,0,1
"USP1",22,9,13,0,1
"MED1",23,9,14,0,1
"P4HB",32,20,12,0,1
"PPARGC1A",34,10,24,0,1
"CALR",33,18,15,0,1
"SEC61A1",40,4,36,0,1
"APOBEC3B",3,1,2,0,1
"AQP7",5,3,2,0,1
"HSPA4",67,33,34,0,1
"SLC9A3",5,2,3,0,1
"PLIN1",16,6,10,0,1
"AR",27,12,15,0,1
"FOXO1",22,11,11,0,1
"HSPA1L",19,15,4,0,1
"ARF6",35,17,18,0,1
"ARHGAP10",6,2,4,0,1
"ARHGDIB",11,3,8,0,1
"GRIP1",20,12,8,0,1
"ARL9",2,1,1,0,1
"IQCD",5,3,2,0,1
"FCGR1A",29,16,13,0,1
"FCGR3A",42,22,20,0,1
"IPO4",21,7,14,0,1
"PCNA",116,89,27,0,1
"RBBP4",67,48,19,0,1
"HIST1H4H",50,30,20,0,1
"CERS2",8,3,5,0,1
"CKS2",63,44,19,0,1
"KIF2A",10,7,3,0,1
"RBBP8",40,36,4,0,1
"ASPN",7,5,2,0,1
"CEBPA",21,20,1,0,1
"JUN",52,19,33,0,1
"CANT1",13,6,7,0,1
"ATP1A4",8,5,3,0,1
"ATP2A3",5,3,2,0,1
"CACNA1D",19,6,13,0,1
"COX6C",16,15,1,0,1
"UQCR10",21,10,11,0,1
"ATP6V1G1",11,7,4,0,1
"ATP6V0D2",15,4,11,0,1
"TMEM30B",3,2,1,0,1
"MAPRE1",19,12,7,0,1
"PRIM1",62,39,23,0,1
"UBE2N",36,11,25,0,1
"NDC1",32,21,11,0,1
"PPP1CA",44,20,24,0,1
"GABRA3",4,1,3,0,1
"FUT2",8,7,1,0,1
"B4GALT1",21,11,10,0,1
"FUT8",10,6,4,0,1
"MGAT5",5,4,1,0,1
"MAF",10,4,6,0,1
"BAK1",9,7,2,0,1
"BAMBI",9,5,4,0,1
"BMP7",13,10,3,0,1
"GREM1",9,8,1,0,1
"TIPIN",43,10,33,0,1
"PIM1",14,12,2,0,1
"RORC",9,4,5,0,1
"HIST1H2AD",49,17,32,0,1
"HIST1H2BK",51,23,28,0,1
"ELN",20,14,6,0,1
"TNF",112,97,15,0,1
"RPA4",15,8,7,0,1
"FGR",37,25,12,0,1
"PTPN6",50,40,10,0,1
"SYK",61,44,17,0,1
"LAMA3",35,17,18,0,1
"BSCL2",9,5,4,0,1
"DCAF13",19,6,13,0,1
"ERBB4",34,18,16,0,1
"GNL3L",18,10,8,0,1
"DHCR7",15,11,4,0,1
"SYCE1",8,3,5,0,1
"C1GALT1C1",21,7,14,0,1
"MUC21",15,5,10,0,1
"TOR1AIP2",4,2,2,0,1
"CYP24A1",6,1,5,0,1
"SLC26A3",7,5,2,0,1
"CACYBP",9,6,3,0,1
"EPB41L2",9,3,6,0,1
"PVRL3",8,6,2,0,1
"CADM3",6,3,3,0,1
"CALML5",9,7,2,0,1
"F11R",23,10,13,0,1
"PKM",29,12,17,0,1
"CANX",39,6,33,0,1
"EDEM3",14,7,7,0,1
"ITIH4",18,4,14,0,1
"RPN1",23,10,13,0,1
"LRRK2",24,5,19,0,1
"EVPL",8,3,5,0,1
"KIAA0196",6,2,4,0,1
"NLGN1",12,7,5,0,1
"CFLAR",13,8,5,0,1
"FASLG",21,15,6,0,1
"PTBP2",9,6,3,0,1
"LPAR1",15,12,3,0,1
"LDB3",17,11,6,0,1
"EPHA2",22,13,9,0,1
"FGFR1",33,28,5,0,1
"KSR1",13,10,3,0,1
"ERBB2",59,19,40,0,1
"FCER1A",6,3,3,0,1
"CETN2",21,17,4,0,1
"CHD4",54,23,31,0,1
"RBM44",5,2,3,0,1
"RET",14,8,6,0,1
"CCL11",38,14,24,0,1
"CCR8",23,9,14,0,1
"CXCR3",35,21,14,0,1
"CCR5",55,14,41,0,1
"TSLP",12,7,5,0,1
"IL12B",18,2,16,0,1
"IL18",33,10,23,0,1
"PSMD14",29,26,3,0,1
"CD86",49,23,26,0,1
"ILF2",19,10,9,0,1
"PPP2R2C",12,7,5,0,1
"TUBA1B",23,15,8,0,1
"TUBB4B",17,15,2,0,1
"RUVBL1",62,19,43,0,1
"TUBB6",10,4,6,0,1
"CD209",18,6,12,0,1
"CD3G",28,25,3,0,1
"CD300C",11,4,7,0,1
"MAP1LC3A",6,4,2,0,1
"IL2RG",34,24,10,0,1
"PTPRJ",20,16,4,0,1
"IL33",10,7,3,0,1
"TNFRSF8",11,3,8,0,1
"ITGA10",17,8,9,0,1
"ITGB6",25,8,17,0,1
"PPP2R3A",4,2,2,0,1
"JUP",23,18,5,0,1
"PKP3",15,7,8,0,1
"FBXO45",4,3,1,0,1
"VANGL2",12,8,4,0,1
"POLR2K",23,13,10,0,1
"PLD4",9,7,2,0,1
"PIP",4,2,2,0,1
"ESR1",30,18,12,0,1
"KLF4",10,7,3,0,1
"CENPH",29,7,22,0,1
"SLC22A1",3,2,1,0,1
"CES1",10,7,3,0,1
"CFAP45",3,1,2,0,1
"MARVELD2",14,7,7,0,1
"MEAF6",15,8,7,0,1
"OPN3",3,2,1,0,1
"GDF5",9,4,5,0,1
"RAPSN",14,2,12,0,1
"MMP1",29,18,11,0,1
"DCK",19,5,14,0,1
"DTYMK",14,7,7,0,1
"CNOT6",6,2,4,0,1
"PABPC1",22,3,19,0,1
"DPP6",9,5,4,0,1
"COL9A1",8,3,5,0,1
"CPLX2",10,5,5,0,1
"LEO1",13,3,10,0,1
"SNRPE",42,34,8,0,1
"INADL",8,3,5,0,1
"POMC",32,26,6,0,1
"CRNKL1",13,10,3,0,1
"CSAG1",3,2,1,0,1
"SNCA",33,16,17,0,1
"RNF20",14,9,5,0,1
"CYP11A1",11,1,10,0,1
"SOAT2",9,4,5,0,1
"KL",12,9,3,0,1
"IDH2",12,6,6,0,1
"KDR",58,11,47,0,1
"DARS2",7,2,5,0,1
"DYNC1I1",11,6,5,0,1
"HNRNPAB",7,3,4,0,1
"GLE1",8,4,4,0,1
"PNPLA2",19,12,7,0,1
"EBP",3,2,1,0,1
"DLG3",19,11,8,0,1
"DLL1",14,7,7,0,1
"NEURL1",3,2,1,0,1
"LHX6",4,2,2,0,1
"HSPA13",11,4,7,0,1
"MAPK10",20,11,9,0,1
"TCTEX1D2",6,1,5,0,1
"TUBB",18,9,9,0,1
"EFNA3",9,7,2,0,1
"EPHB3",10,3,7,0,1
"RRAS",20,2,18,0,1
"MRPL17",28,9,19,0,1
"SIAH2",3,2,1,0,1
"IFIH1",31,6,25,0,1
"IRS2",23,17,6,0,1
"ENKUR",3,1,2,0,1
"EPHA1",11,2,9,0,1
"FGFR3",17,10,7,0,1
"F10",14,9,5,0,1
"RAD54B",16,6,10,0,1
"REV3L",21,10,11,0,1
"SMC1B",21,12,9,0,1
"GRM2",7,4,3,0,1
"GATA3",14,7,7,0,1
"SIN3B",11,9,2,0,1
"PPL",13,5,8,0,1
"TDRKH",10,6,4,0,1
"RAB8A",26,10,16,0,1
"WT1",8,3,5,0,1
"ZNF217",4,2,2,0,1
"S1PR1",13,5,8,0,1
"SORD",10,2,8,0,1
"NOVA2",3,1,2,0,1
"TNFRSF6B",3,1,2,0,1
"MNDA",6,3,3,0,1
"MASP1",9,4,5,0,1
"PLXNA4",13,12,1,0,1
"SH3TC2",2,1,1,0,1
"PTX3",6,4,2,0,1
"PIWIL2",6,4,2,0,1
"FLAD1",5,2,3,0,1
"SLC46A1",2,1,1,0,1
"NKX3-2",6,5,1,0,1
"FUT3",7,1,6,0,1
"MUC3A",21,9,12,0,1
"MAPK7",9,4,5,0,1
"SNRPD1",30,11,19,0,1
"TAC1",16,7,9,0,1
"GOLT1A",4,3,1,0,1
"LYPD1",2,1,1,0,1
"RAB25",4,3,1,0,1
"IRF6",12,3,9,0,1
"P2RX6",7,6,1,0,1
"GRM7",3,1,2,0,1
"GUCY2D",14,3,11,0,1
"VPS72",17,6,11,0,1
"KLK2",17,4,13,0,1
"HAND2",6,1,5,0,1
"HMGN1",4,2,2,0,1
"HOXA5",10,2,8,0,1
"MEIS1",16,3,13,0,1
"SULF1",4,2,2,0,1
"KIF3B",10,5,5,0,1
"SORBS1",6,5,1,0,1
"KCNAB3",11,6,5,0,1
"KCNE1",9,3,6,0,1
"KCNB1",12,8,4,0,1
"KCTD1",4,3,1,0,1
"KLK4",3,1,2,0,1
"KMO",5,2,3,0,1
"KRT5",11,1,10,0,1
"NLGN2",11,3,8,0,1
"SND1",5,4,1,0,1
"MRAS",10,3,7,0,1
"NEFH",5,2,3,0,1
"MEOX2",2,1,1,0,1
"MERTK",9,3,6,0,1
"PIGC",8,4,4,0,1
"TIMD4",4,1,3,0,1
"TIMP1",18,2,16,0,1
"TEX11",5,3,2,0,1
"MPP6",5,1,4,0,1
"MRPL48",20,8,12,0,1
"SOX10",9,3,6,0,1
"TNNT3",24,6,18,0,1
"NOD1",10,2,8,0,1
"PDXDC1",3,1,2,0,1
"PIP4K2C",4,2,2,0,1
"PPP1R14A",5,2,3,0,1
"XKR4",2,1,1,0,1
"PLXNC1",7,1,6,0,1
"PTGDR2",3,2,1,0,1
"PVRL2",6,1,5,0,1
"SNAP25",41,4,37,0,1
"RGR",3,2,1,0,1
"STAB1",3,1,2,0,1
"SRPRB",8,7,1,0,1
"TBX18",4,2,2,0,1
"SLC40A1",5,1,4,0,1
"SLC24A2",2,1,1,0,1
"TNFSF15",2,1,1,0,1
