"Name","K","Kin","Kout","TypeI","TypeII"
"NGF",24,17,7,0,1
"RAB3IL1",3,2,1,0,1
"KARS",22,11,11,0,1
"RPL39",29,15,14,0,1
"RPS21",41,19,22,0,1
"RPS26",45,25,20,0,1
"RUVBL1",62,20,42,0,1
"NRAS",52,32,20,0,1
"ABL1",35,23,12,0,1
"ABT1",21,4,17,0,1
"PARK2",29,18,11,0,1
"TAC1",8,3,5,0,1
"PKM",27,10,17,0,1
"ACTA1",42,20,22,0,1
"ACTA2",24,18,6,0,1
"FLNA",26,16,10,0,1
"DMD",43,18,25,0,1
"TPM1",29,10,19,0,1
"CAMK2A",32,22,10,0,1
"CDC42",59,46,13,0,1
"ACY1",2,1,1,0,1
"BAK1",18,13,5,0,1
"BAX",23,7,16,0,1
"JUP",22,18,4,0,1
"RHBDF2",4,3,1,0,1
"ADCY2",22,12,10,0,1
"ADCY4",21,9,12,0,1
"GNAL",13,6,7,0,1
"GNAI3",25,12,13,0,1
"GNG7",25,17,8,0,1
"ADH1B",12,5,7,0,1
"AOX1",15,10,5,0,1
"ALDH1B1",8,4,4,0,1
"GSTP1",11,10,1,0,1
"POMC",15,11,4,0,1
"P2RY2",5,3,2,0,1
"NPEPL1",7,3,4,0,1
"GGCT",8,3,5,0,1
"SRM",2,1,1,0,1
"AGTR1",8,7,1,0,1
"APLNR",2,1,1,0,1
"JAK2",43,33,10,0,1
"AR",12,5,7,0,1
"HSP90AA1",85,49,36,0,1
"HSPA4",61,34,27,0,1
"YARS",17,14,3,0,1
"AKAP13",10,4,6,0,1
"FYN",60,27,33,0,1
"LCK",32,13,19,0,1
"AMT",5,1,4,0,1
"COMT",8,5,3,0,1
"STT3A",32,21,11,0,1
"DPM1",13,8,5,0,1
"KCNB1",9,7,2,0,1
"AMPH",7,2,5,0,1
"MTR",10,4,6,0,1
"CDK1",230,186,44,0,1
"NEK2",91,57,34,0,1
"TEK",20,17,3,0,1
"ANK2",19,12,7,0,1
"SCN3B",12,9,3,0,1
"ASPM",132,86,46,0,1
"AURKB",157,70,87,0,1
"BUB1",162,61,101,0,1
"CCNA2",177,53,124,0,1
"CD2AP",15,12,3,0,1
"CDC25C",78,37,41,0,1
"CDCA8",140,101,39,0,1
"KIF15",103,53,50,0,1
"SHCBP1",57,28,29,0,1
"TTK",135,89,46,0,1
"TYMS",104,56,48,0,1
"ZWINT",96,67,29,0,1
"HSPA8",61,56,5,0,1
"ARF6",19,7,12,0,1
"CALR",38,18,20,0,1
"HSPG2",30,20,10,0,1
"APOBEC3B",6,2,4,0,1
"TOMM40",23,17,6,0,1
"PLIN1",9,3,6,0,1
"KDELR1",20,14,6,0,1
"RAC1",66,28,38,0,1
"ITGA8",25,14,11,0,1
"MET",21,7,14,0,1
"NME1",26,12,14,0,1
"RAC3",21,8,13,0,1
"ARHGEF9",4,1,3,0,1
"PSMB2",50,36,14,0,1
"FCGR1A",15,8,7,0,1
"KCTD7",3,1,2,0,1
"CHAF1B",28,17,11,0,1
"FEN1",96,43,53,0,1
"HIST1H3D",40,25,15,0,1
"PCNA",109,83,26,0,1
"RAD51",103,79,24,0,1
"STIL",33,23,10,0,1
"SMC4",83,49,34,0,1
"BLM",65,29,36,0,1
"DNA2",47,22,25,0,1
"RAD52",32,18,14,0,1
"RFC3",77,59,18,0,1
"ATG7",14,9,5,0,1
"ATOX1",7,6,1,0,1
"PLA2G6",7,3,4,0,1
"PRKG1",23,15,8,0,1
"PLN",10,4,6,0,1
"NDUFS5",24,18,6,0,1
"HDAC4",10,3,7,0,1
"CCNB1",191,27,164,0,1
"GMNN",71,12,59,0,1
"NDC80",140,24,116,0,1
"PRIM1",75,48,27,0,1
"UBE2N",33,14,19,0,1
"CASC5",58,29,29,0,1
"ERCC6L",32,17,15,0,1
"KLHL13",5,4,1,0,1
"PPP1CA",42,22,20,0,1
"STMN1",9,8,1,0,1
"CSPG4",16,8,8,0,1
"B4GALT1",11,6,5,0,1
"BAG2",7,3,4,0,1
"HSPA1B",19,14,5,0,1
"HSPA5",59,30,29,0,1
"BANF1",12,5,7,0,1
"SNRPD2",68,37,31,0,1
"BCL2L1",33,11,22,0,1
"CYCS",37,13,24,0,1
"NTRK3",12,5,7,0,1
"SFN",29,17,12,0,1
"BBS1",7,3,4,0,1
"WDR19",5,3,2,0,1
"CEBPD",3,2,1,0,1
"BEGAIN",3,2,1,0,1
"BGN",16,6,10,0,1
"BIN1",8,3,5,0,1
"MAPT",28,14,14,0,1
"RMI1",32,9,23,0,1
"ISG15",29,23,6,0,1
"MX1",29,24,5,0,1
"CDC7",48,42,6,0,1
"SNRPE",78,63,15,0,1
"MRPL37",31,19,12,0,1
"NIP7",54,10,44,0,1
"PUS1",12,11,1,0,1
"DHCR7",15,8,7,0,1
"C1GALT1C1",7,2,5,0,1
"SLC39A9",6,3,3,0,1
"C4A",14,9,5,0,1
"CD34",21,12,9,0,1
"CACNA1H",15,4,11,0,1
"TRPC4",6,4,2,0,1
"LMOD1",11,5,6,0,1
"P4HB",32,15,17,0,1
"CAMK2G",8,3,5,0,1
"NRXN1",15,13,2,0,1
"DSP",10,7,3,0,1
"TXN",22,15,7,0,1
"CCDC40",6,3,3,0,1
"PSMD14",57,49,8,0,1
"PSMD2",48,26,22,0,1
"UCHL5",33,19,14,0,1
"CCR8",16,9,7,0,1
"CXCL10",29,11,18,0,1
"CSF2",22,9,13,0,1
"CXCL8",25,9,16,0,1
"IL1B",23,5,18,0,1
"NOP10",25,14,11,0,1
"TEN1-CDK3",19,17,2,0,1
"TERT",33,13,20,0,1
"WRAP53",19,13,6,0,1
"PRKAR2B",21,4,17,0,1
"RCC1",21,14,7,0,1
"YWHAG",20,8,12,0,1
"PSMB10",36,20,16,0,1
"PSMB5",40,26,14,0,1
"HSP90B1",34,13,21,0,1
"ILF2",18,13,5,0,1
"PFDN2",18,15,3,0,1
"VBP1",20,9,11,0,1
"HSPH1",18,10,8,0,1
"CD163",13,7,6,0,1
"PROM1",7,5,2,0,1
"HLA-DRA",19,11,8,0,1
"CD80",24,3,21,0,1
"ITGA5",34,8,26,0,1
"FGFR1",28,23,5,0,1
"GFRA1",12,4,8,0,1
"IGF1",39,18,21,0,1
"PKP3",12,5,7,0,1
"GADD45GIP1",30,16,14,0,1
"POLR2K",23,16,7,0,1
"CDS1",4,2,2,0,1
"LCLAT1",4,3,1,0,1
"SASS6",7,3,4,0,1
"CERS4",3,2,1,0,1
"EFHC1",3,2,1,0,1
"CFAP69",5,2,3,0,1
"CYP19A1",8,6,2,0,1
"NTRK2",19,5,14,0,1
"FMOD",8,4,4,0,1
"SLC12A5",2,1,1,0,1
"CKLF",2,1,1,0,1
"DTYMK",14,7,7,0,1
"RD3",3,2,1,0,1
"HPSE2",8,3,5,0,1
"CNTFR",3,2,1,0,1
"COA3",4,2,2,0,1
"P4HA1",14,3,11,0,1
"COLGALT2",7,2,5,0,1
"SEC23B",9,4,5,0,1
"COX17",17,4,13,0,1
"PPFIA3",6,2,4,0,1
"PVRL2",7,2,5,0,1
"TGFA",10,4,6,0,1
"TXNDC5",6,3,3,0,1
"CXCL11",13,6,7,0,1
"MAP2K3",15,10,5,0,1
"MYD88",14,11,3,0,1
"CYP2D6",6,3,3,0,1
"KRTCAP2",13,3,10,0,1
"SEC61G",31,22,9,0,1
"SSR3",22,8,14,0,1
"HNRNPAB",7,4,3,0,1
"GDI2",7,3,4,0,1
"PLCB4",13,9,4,0,1
"NLGN1",11,10,1,0,1
"SGCE",11,10,1,0,1
"DNALI1",4,2,2,0,1
"HSPA13",17,6,11,0,1
"DOK6",3,2,1,0,1
"SMARCA4",24,14,10,0,1
"NCS1",5,3,2,0,1
"GNB3",22,2,20,0,1
"SLC6A3",5,2,3,0,1
"SPRY2",3,2,1,0,1
"E2F1",23,5,18,0,1
"EZH2",39,7,32,0,1
"MEF2C",14,5,9,0,1
"UGGT1",13,2,11,0,1
"PRKCB",25,9,16,0,1
"HK2",14,6,8,0,1
"ENPP1",14,5,9,0,1
"KITLG",21,5,16,0,1
"FIGF",11,6,5,0,1
"SMC1B",15,8,7,0,1
"F10",5,4,1,0,1
"TMC1",4,2,2,0,1
"KIT",21,7,14,0,1
"NTF3",10,7,3,0,1
"TRPC3",10,6,4,0,1
"FLNC",14,6,8,0,1
"NRP2",10,8,2,0,1
"SLC3A2",9,6,3,0,1
"TFAP2A",7,3,4,0,1
"GABARAPL1",6,1,5,0,1
"HPRT1",16,3,13,0,1
"HAND2",6,4,2,0,1
"GBA2",3,2,1,0,1
"HK3",3,2,1,0,1
"PDLIM7",6,3,3,0,1
"GIMAP8",3,1,2,0,1
"GPSM2",4,3,1,0,1
"MAGI2",6,2,4,0,1
"SLC18A2",8,3,5,0,1
"HFM1",3,2,1,0,1
"TEX11",3,2,1,0,1
"JAZF1",4,1,3,0,1
"HMGN1",3,2,1,0,1
"MEIS1",8,4,4,0,1
"HOXA5",5,1,4,0,1
"IL22RA1",4,1,3,0,1
"ING5",6,3,3,0,1
"PLAU",7,6,1,0,1
"TLN2",8,7,1,0,1
"PNPLA7",5,3,2,0,1
"LACTB2",2,1,1,0,1
"MZT2A",6,4,2,0,1
"SYNM",6,2,4,0,1
"PLXNA1",9,8,1,0,1
"TNS1",18,1,17,0,1
"PPARGC1A",13,4,9,0,1
"MARVELD2",4,2,2,0,1
"MASP1",7,1,6,0,1
"RAB10",11,2,9,0,1
"PIWIL4",7,2,5,0,1
"PLA2G4A",4,2,2,0,1
"NPHP1",6,2,4,0,1
"NPHP3",5,3,2,0,1
"PTBP2",3,1,2,0,1
"NPR2",8,3,5,0,1
"SEMA4A",2,1,1,0,1
"NTN1",14,1,13,0,1
"NUDT1",3,1,2,0,1
"PLA2G5",5,3,2,0,1
"PLXNB3",3,2,1,0,1
"POLR3K",14,3,11,0,1
"REV3L",9,3,6,0,1
"SLC8A3",3,2,1,0,1
"RXRG",6,2,4,0,1
"RHOD",3,1,2,0,1
"RND2",2,1,1,0,1
"WIF1",4,2,2,0,1
"TCF7",8,1,7,0,1
"TACR2",2,1,1,0,1
"TCEAL1",3,1,2,0,1
"TMOD1",14,2,12,0,1
"TUBG1",10,2,8,0,1
