"Name","K","Kin","Kout","TypeI","TypeII"
"AADAT",5,2,3,0,1
"AASS",3,1,2,0,1
"RHOA",58,47,11,0,1
"GBA",7,4,3,0,1
"CPT1B",4,2,2,0,1
"ACTA1",24,16,8,0,1
"PECAM1",19,17,2,0,1
"ACTB",86,43,43,0,1
"CETN2",14,7,7,0,1
"CHEK1",112,101,11,0,1
"DLG4",50,38,12,0,1
"GSN",8,6,2,0,1
"H3F3A",19,14,5,0,1
"HIST1H4H",26,17,9,0,1
"HSP90AB1",36,26,10,0,1
"PROM1",9,5,4,0,1
"SQSTM1",17,11,6,0,1
"YWHAZ",38,31,7,0,1
"COL1A2",22,11,11,0,1
"ADCY1",9,3,6,0,1
"CAMK2B",24,16,8,0,1
"WNT3A",14,5,9,0,1
"AGER",7,6,1,0,1
"LTB4R",2,1,1,0,1
"GNPAT",11,4,7,0,1
"NPHP4",6,4,2,0,1
"AHSP",11,4,7,0,1
"HSPA4",40,18,22,0,1
"NME1-NME2",20,14,6,0,1
"HKDC1",13,8,5,0,1
"AKR1C1",15,8,7,0,1
"CYP2A6",21,9,12,0,1
"CYP2B6",22,10,12,0,1
"CYP3A4",37,20,17,0,1
"CYP2C9",27,7,20,0,1
"INHA",3,1,2,0,1
"DNM1",12,6,6,0,1
"ANAPC11",18,11,7,0,1
"CDC20",137,95,42,0,1
"CDK1",184,150,34,0,1
"NEK2",89,54,35,0,1
"TOMM7",14,6,8,0,1
"MET",21,10,11,0,1
"GJA1",22,7,15,0,1
"NFASC",8,3,5,0,1
"NRCAM",7,3,4,0,1
"ASPM",119,75,44,0,1
"AURKB",133,61,72,0,1
"BUB1",147,57,90,0,1
"CCNA2",149,42,107,0,1
"CDC25C",67,29,38,0,1
"CDCA8",121,85,36,0,1
"CENPA",104,53,51,0,1
"CENPF",109,65,44,0,1
"CEP55",102,70,32,0,1
"DIAPH3",18,14,4,0,1
"KIF15",95,48,47,0,1
"KIF2C",123,88,35,0,1
"KIF4A",100,74,26,0,1
"MKI67",87,56,31,0,1
"RACGAP1",87,77,10,0,1
"RHOC",15,4,11,0,1
"RRM2",127,70,57,0,1
"SH3KBP1",7,3,4,0,1
"TTK",124,80,44,0,1
"TYMS",88,46,42,0,1
"UBE2C",116,65,51,0,1
"ZWINT",90,64,26,0,1
"VPS72",7,4,3,0,1
"ANXA11",3,2,1,0,1
"ANXA2",14,6,8,0,1
"AP1S1",5,3,2,0,1
"DNAJC6",13,9,4,0,1
"CAMK2A",16,10,6,0,1
"KSR1",15,14,1,0,1
"SORT1",18,5,13,0,1
"GPC3",16,13,3,0,1
"ERBB4",17,7,10,0,1
"HP",19,10,9,0,1
"HSPG2",38,27,11,0,1
"SDC2",16,4,12,0,1
"AQP7",2,1,1,0,1
"PLIN1",3,1,2,0,1
"NAGS",3,1,2,0,1
"RAC1",56,23,33,0,1
"FCGR1A",18,12,6,0,1
"PSMA7",33,20,13,0,1
"ARSF",2,1,1,0,1
"H2AFZ",45,9,36,0,1
"PCNA",85,65,20,0,1
"CDT1",76,32,44,0,1
"RAD51",85,66,19,0,1
"RRM1",63,26,37,0,1
"CKS2",62,44,18,0,1
"KIF20B",42,27,15,0,1
"CBX2",14,5,9,0,1
"DSCC1",34,21,13,0,1
"ATG7",13,5,8,0,1
"UBA52",118,92,26,0,1
"ATL1",4,3,1,0,1
"ATP2A1",8,3,5,0,1
"RYR2",8,5,3,0,1
"ATP5I",39,16,23,0,1
"COA6",24,15,9,0,1
"COX4I2",24,16,8,0,1
"ATP6V0E1",8,7,1,0,1
"PRIM1",55,34,21,0,1
"UBE2T",50,33,17,0,1
"CASC5",52,27,25,0,1
"GNA14",10,5,5,0,1
"BPI",6,4,2,0,1
"SDC3",16,9,7,0,1
"B3GNT3",12,2,10,0,1
"MUC3A",9,4,5,0,1
"SNRPD2",37,16,21,0,1
"SFN",22,11,11,0,1
"RELB",7,1,6,0,1
"VRK1",6,2,4,0,1
"BFSP2",7,4,3,0,1
"MT-CYB",23,6,17,0,1
"ZAP70",17,3,14,0,1
"BLM",45,19,26,0,1
"DNA2",35,14,21,0,1
"HIST1H2BK",28,12,16,0,1
"RPA4",14,7,7,0,1
"BSG",19,12,7,0,1
"CD2",21,12,9,0,1
"SLC3A2",12,9,3,0,1
"ESCO2",52,23,29,0,1
"RPS11",57,11,46,0,1
"RRS1",20,6,14,0,1
"UTP14A",15,8,7,0,1
"C1orf111",2,1,1,0,1
"C1QB",16,9,7,0,1
"CTSS",22,8,14,0,1
"MPEG1",4,3,1,0,1
"TREM2",10,5,5,0,1
"DXO",3,1,2,0,1
"CATSPER2",7,5,2,0,1
"GRIN1",18,11,7,0,1
"CALML6",3,1,2,0,1
"HLA-C",36,22,14,0,1
"CRIP1",2,1,1,0,1
"FN1",51,26,25,0,1
"PTGS2",14,7,7,0,1
"HIST2H2AC",38,14,24,0,1
"CXCL9",22,14,8,0,1
"CXCR3",23,15,8,0,1
"CCL20",14,10,4,0,1
"CCR9",9,4,5,0,1
"CD86",35,14,21,0,1
"TSC1",16,6,10,0,1
"TUBA1B",21,14,7,0,1
"EEF1G",44,15,29,0,1
"RPL8",59,9,50,0,1
"LY96",11,2,9,0,1
"CD1C",16,10,6,0,1
"KLRD1",14,8,6,0,1
"NRAS",39,20,19,0,1
"NES",12,6,6,0,1
"CSF1R",23,5,18,0,1
"CTSA",11,5,6,0,1
"FCGR2B",12,8,4,0,1
"POSTN",9,8,1,0,1
"CDH23",3,2,1,0,1
"CTRC",3,2,1,0,1
"CES1",8,6,2,0,1
"CFAP69",4,1,3,0,1
"MTX1",8,7,1,0,1
"CHIT1",4,2,2,0,1
"NTRK2",14,3,11,0,1
"IGF1",24,11,13,0,1
"MYOZ1",11,6,5,0,1
"CNTF",6,4,2,0,1
"CRTAP",12,7,5,0,1
"VWF",13,2,11,0,1
"COPS6",16,5,11,0,1
"COPA",5,1,4,0,1
"UCN",2,1,1,0,1
"MAGED2",2,1,1,0,1
"EIF4B",11,7,4,0,1
"MPO",10,1,9,0,1
"DAP3",15,9,6,0,1
"KDR",32,6,26,0,1
"MMP7",8,3,5,0,1
"TLR2",25,4,21,0,1
"UFC1",3,2,1,0,1
"DKK1",12,8,4,0,1
"DLGAP2",3,2,1,0,1
"NOTCH3",15,4,11,0,1
"DLL1",7,5,2,0,1
"HFM1",5,4,1,0,1
"TCTE3",5,3,2,0,1
"E2F1",20,2,18,0,1
"NGF",15,9,6,0,1
"IL27RA",3,1,2,0,1
"SMC1B",12,8,4,0,1
"ZFC3H1",6,4,2,0,1
"GNA15",13,3,10,0,1
"UXS1",3,1,2,0,1
"GCNT4",5,1,4,0,1
"SNRPD1",30,11,19,0,1
"KL",7,6,1,0,1
"POMC",14,10,4,0,1
"GABBR1",6,4,2,0,1
"NEU4",2,1,1,0,1
"RET",4,2,2,0,1
"GNB1L",2,1,1,0,1
"GZMA",7,2,5,0,1
"PIGC",5,4,1,0,1
"NEGR1",3,2,1,0,1
"HYDIN",6,2,4,0,1
"PPP1R3B",4,3,1,0,1
"SLC18A2",5,1,4,0,1
"LAMA3",16,10,6,0,1
"PKM",28,6,22,0,1
"KIR2DL1",12,4,8,0,1
"VPS35",13,4,9,0,1
"IL1RAP",4,2,2,0,1
"PTPRD",4,2,2,0,1
"PTPRS",7,1,6,0,1
"KCNAB3",7,4,3,0,1
"KRT16",4,3,1,0,1
"S100A8",7,3,4,0,1
"MAPK8IP2",2,1,1,0,1
"PPARG",20,2,18,0,1
"NOD2",9,3,6,0,1
"PLXNB1",8,5,3,0,1
"MUSK",2,1,1,0,1
"NR5A1",3,1,2,0,1
"NSMCE2",7,1,6,0,1
"PITX1",2,1,1,0,1
"PRKG2",5,2,3,0,1
"PLXNC1",4,1,3,0,1
"PRND",2,1,1,0,1
"PYGB",7,1,6,0,1
"RFXANK",3,1,2,0,1
"TEX19",2,1,1,0,1
"SLC1A3",3,1,2,0,1
"SLC34A1",3,1,2,0,1
"SLC6A13",2,1,1,0,1
"XXYLT1",2,1,1,0,1
"TNFRSF10B",3,1,2,0,1
