"Name","K","Kin","Kout","TypeI","TypeII"
"A2M",21,14,7,0,1
"B2M",69,65,4,0,1
"HP",23,11,12,0,1
"HSPA5",52,28,24,0,1
"ABCA2",7,4,3,0,1
"ATP1B1",11,6,5,0,1
"ACTB",116,64,52,0,1
"BBS10",26,21,5,0,1
"FAU",90,79,11,0,1
"PES1",55,30,25,0,1
"RPS15A",87,27,60,0,1
"RPS2",91,36,55,0,1
"RUVBL1",50,21,29,0,1
"EGFR",87,26,61,0,1
"NPC1L1",4,2,2,0,1
"ABL1",42,27,15,0,1
"ROBO1",18,16,2,0,1
"SLC4A1",7,2,5,0,1
"ACACB",5,3,2,0,1
"NGF",33,16,17,0,1
"SAG",18,11,7,0,1
"PGM2",14,10,4,0,1
"ACOT12",4,2,2,0,1
"ACOT7",3,2,1,0,1
"THEM5",3,2,1,0,1
"LPL",17,9,8,0,1
"EZR",24,15,9,0,1
"ITGB1",98,71,27,0,1
"MYH11",11,8,3,0,1
"TNNC2",15,9,6,0,1
"WAS",37,20,17,0,1
"CD44",74,63,11,0,1
"CTGF",16,9,7,0,1
"DLG4",107,79,28,0,1
"PTPRC",101,89,12,0,1
"SPTBN2",11,9,2,0,1
"TNF",93,79,14,0,1
"XIAP",28,18,10,0,1
"ACTR1B",8,1,7,0,1
"APH1A",16,14,2,0,1
"CD9",20,12,8,0,1
"CDH2",26,7,19,0,1
"CTNNB1",150,85,65,0,1
"DLL1",13,11,2,0,1
"MMP14",18,7,11,0,1
"NOTCH1",48,21,27,0,1
"TIMP3",10,5,5,0,1
"ADAMTS14",22,17,5,0,1
"THSD7A",14,11,3,0,1
"COL1A2",29,10,19,0,1
"COL5A1",19,14,5,0,1
"BCAN",17,9,8,0,1
"ADARB1",3,1,2,0,1
"SLC39A1",11,7,4,0,1
"FBXL6",2,1,1,0,1
"ADCY5",25,24,1,0,1
"GNAI2",83,28,55,0,1
"ADCY10",6,3,3,0,1
"CHEK2",51,40,11,0,1
"ADCY4",7,3,4,0,1
"GNAI3",66,40,26,0,1
"CYP2E1",21,17,4,0,1
"ADH5",12,4,8,0,1
"OPRM1",12,9,3,0,1
"TFPI",5,2,3,0,1
"AFP",16,14,2,0,1
"C1orf27",3,1,2,0,1
"NPHP4",7,2,5,0,1
"S100A10",14,12,2,0,1
"AK5",7,4,3,0,1
"NME2",13,10,3,0,1
"RRM2",116,68,48,0,1
"PKLR",23,7,16,0,1
"SURF4",20,17,3,0,1
"PRKAR2A",23,2,21,0,1
"ENO2",21,17,4,0,1
"AKR1C3",9,5,4,0,1
"ALAS2",8,3,5,0,1
"HBD",7,6,1,0,1
"HBG2",6,5,1,0,1
"ALB",47,18,29,0,1
"CAV1",44,20,24,0,1
"CD8A",83,64,19,0,1
"FN1",97,56,41,0,1
"LAMP1",15,9,6,0,1
"NPHS1",12,6,6,0,1
"PLG",25,10,15,0,1
"SERPINC1",23,18,5,0,1
"ALDH18A1",16,6,10,0,1
"ASS1",14,9,5,0,1
"GART",43,26,17,0,1
"COMT",11,3,8,0,1
"ALG8",8,4,4,0,1
"ITIH2",6,4,2,0,1
"AMFR",14,5,9,0,1
"AMPH",17,6,11,0,1
"CNTNAP2",15,6,9,0,1
"DNM1",35,20,15,0,1
"EHD1",8,7,1,0,1
"GAD2",49,35,14,0,1
"FYN",68,37,31,0,1
"ANK1",19,2,17,0,1
"ITPR3",15,11,4,0,1
"SCN2A",27,15,12,0,1
"SCN8A",14,6,8,0,1
"FAM63A",3,1,2,0,1
"IMPDH2",12,5,7,0,1
"ANXA2",18,9,9,0,1
"CASP3",66,25,41,0,1
"TLN1",29,10,19,0,1
"AP1G2",3,2,1,0,1
"AP3B1",9,2,7,0,1
"AP3M1",5,2,3,0,1
"CACNA1B",28,20,8,0,1
"CASK",17,11,6,0,1
"GRIN1",59,35,24,0,1
"GRIN2C",20,7,13,0,1
"PPFIA3",23,15,8,0,1
"SYN1",39,13,26,0,1
"ILF2",29,17,12,0,1
"PCNA",95,73,22,0,1
"SET",9,6,3,0,1
"SDC3",28,13,15,0,1
"P4HB",37,21,16,0,1
"SPINK5",5,3,2,0,1
"CANX",55,10,45,0,1
"HSP90B1",33,13,20,0,1
"TLR4",66,39,27,0,1
"BDNF",38,33,5,0,1
"SNCA",34,15,19,0,1
"AQP5",4,2,2,0,1
"SFTPC",7,3,4,0,1
"CRNKL1",27,20,7,0,1
"SNRPE",66,54,12,0,1
"CREB1",22,13,9,0,1
"CYP19A1",11,9,2,0,1
"COPB2",10,6,4,0,1
"ARF6",32,10,22,0,1
"CRK",45,15,30,0,1
"ITGA8",18,12,6,0,1
"MET",34,13,21,0,1
"CDCA8",111,79,32,0,1
"CDK1",180,148,32,0,1
"CENPF",91,57,34,0,1
"KIF14",61,36,25,0,1
"KIF20A",103,83,20,0,1
"KIF2C",103,78,25,0,1
"TTK",113,77,36,0,1
"ARHGDIB",17,3,14,0,1
"LAPTM5",20,9,11,0,1
"RHOC",21,7,14,0,1
"NRAS",56,28,28,0,1
"NPAS2",10,6,4,0,1
"MAP2K4",14,10,4,0,1
"NKX2-2",8,5,3,0,1
"OLIG2",13,4,9,0,1
"POU3F2",6,4,2,0,1
"SOX2",45,10,35,0,1
"HIST1H4J",23,15,8,0,1
"IPO4",25,13,12,0,1
"MCM7",82,39,43,0,1
"AURKB",126,60,66,0,1
"BUB1",136,52,84,0,1
"BUB1B",128,42,86,0,1
"CENPA",90,48,42,0,1
"HMMR",77,63,14,0,1
"UBE2C",105,63,42,0,1
"PICK1",21,19,2,0,1
"GOT1",25,8,17,0,1
"NAT8L",8,7,1,0,1
"ASPHD1",5,2,3,0,1
"CKS2",50,38,12,0,1
"KIF20B",41,27,14,0,1
"ZWINT",77,56,21,0,1
"KIF15",81,42,39,0,1
"MAD2L1",116,39,77,0,1
"CATSPER2",16,12,4,0,1
"ATP7A",5,1,4,0,1
"POMC",31,26,5,0,1
"ATXN7L3",6,5,1,0,1
"NDEL1",9,3,6,0,1
"PRIM1",57,36,21,0,1
"TYMS",84,42,42,0,1
"CASC5",46,24,22,0,1
"ERCC6L",28,13,15,0,1
"ORC1",43,29,14,0,1
"TPR",35,24,11,0,1
"B3GNT4",8,1,7,0,1
"B4GALT1",15,12,3,0,1
"MUC6",20,13,7,0,1
"MUC3A",14,7,7,0,1
"B4GALNT1",7,3,4,0,1
"B4GALNT4",5,2,3,0,1
"GGT7",13,7,6,0,1
"NCALD",8,4,4,0,1
"BLM",53,27,26,0,1
"CDK2",78,25,53,0,1
"RNF2",23,15,8,0,1
"TIPIN",39,9,30,0,1
"IRF4",23,11,12,0,1
"STAG1",15,13,2,0,1
"CSPG5",15,12,3,0,1
"PTPRZ1",10,7,3,0,1
"TNR",7,4,3,0,1
"BEX2",3,2,1,0,1
"MYO1F",10,4,6,0,1
"SYNJ2",12,6,6,0,1
"CBL",54,10,44,0,1
"LCK",70,24,46,0,1
"SYK",80,50,30,0,1
"CBFB",5,4,1,0,1
"COL4A1",21,17,4,0,1
"TFR2",5,3,2,0,1
"TAF7",12,3,9,0,1
"HOMER1",18,4,14,0,1
"UNC13A",21,20,1,0,1
"CNOT6",10,5,5,0,1
"PABPC1",53,9,44,0,1
"ESCO2",50,23,27,0,1
"SMC3",45,29,16,0,1
"RPS27L",69,20,49,0,1
"C1GALT1C1",12,2,10,0,1
"SLC39A9",11,4,7,0,1
"C1QB",23,10,13,0,1
"CALR",42,22,20,0,1
"YPEL4",4,3,1,0,1
"TOR3A",3,2,1,0,1
"CA4",2,1,1,0,1
"CACNA1E",21,14,7,0,1
"CACNB1",19,14,5,0,1
"CACNA1G",15,7,8,0,1
"CACNA1S",25,15,10,0,1
"CACNG2",36,8,28,0,1
"CALM1",51,22,29,0,1
"KCND2",21,5,16,0,1
"RYR2",20,11,9,0,1
"HTR3A",20,11,9,0,1
"GRIA4",32,8,24,0,1
"SST",24,11,13,0,1
"TH",26,18,8,0,1
"TRPV6",12,6,6,0,1
"FKBP1B",7,5,2,0,1
"HLA-E",49,33,16,0,1
"PTK2B",28,21,7,0,1
"QKI",7,4,3,0,1
"LMAN1",24,4,20,0,1
"CARD11",9,5,4,0,1
"MC4R",9,3,6,0,1
"LIMK1",14,6,8,0,1
"PTBP1",36,15,21,0,1
"UNC5A",7,4,3,0,1
"DPP4",19,11,8,0,1
"GRM1",28,11,17,0,1
"CAV3",16,8,8,0,1
"CSF1R",44,11,33,0,1
"FCER1A",16,10,6,0,1
"FCER1G",43,9,34,0,1
"HLA-DRB1",42,15,27,0,1
"GRID2",13,2,11,0,1
"CHD4",36,25,11,0,1
"SUZ12",17,9,8,0,1
"H3F3C",15,8,7,0,1
"SUV39H2",3,2,1,0,1
"CDC42EP4",4,1,3,0,1
"DSEL",8,4,4,0,1
"CCDC102B",2,1,1,0,1
"CCDC108",3,1,2,0,1
"CCL8",12,10,2,0,1
"CXCL9",27,17,10,0,1
"CCR10",8,4,4,0,1
"CCR5",52,14,38,0,1
"CXCL10",47,20,27,0,1
"IL18",31,10,21,0,1
"PF4",12,6,6,0,1
"TERT",28,10,18,0,1
"NUP43",28,18,10,0,1
"CDK6",22,6,16,0,1
"HIST1H2BK",35,20,15,0,1
"DRC1",13,2,11,0,1
"CXCL14",7,4,3,0,1
"CD2",33,22,11,0,1
"CD86",59,23,36,0,1
"CD1C",20,10,10,0,1
"CD14",26,10,16,0,1
"LILRB2",29,19,10,0,1
"FCGR1A",28,15,13,0,1
"LY96",25,6,19,0,1
"CD5",22,8,14,0,1
"CD247",52,21,31,0,1
"CD276",10,2,8,0,1
"CD3E",36,13,23,0,1
"ITGAL",27,9,18,0,1
"TYROBP",63,9,54,0,1
"HLA-DPA1",29,22,7,0,1
"FCGR2A",37,7,30,0,1
"FCGR2B",27,13,14,0,1
"HLA-DQA1",28,7,21,0,1
"IGSF8",5,2,3,0,1
"PKN1",8,4,4,0,1
"COL3A1",23,10,13,0,1
"LRP5",19,12,7,0,1
"NTRK2",26,8,18,0,1
"THADA",5,2,3,0,1
"CDS1",13,3,10,0,1
"CH25H",4,2,2,0,1
"SYP",35,10,25,0,1
"TLL2",6,5,1,0,1
"F2R",22,9,13,0,1
"CHRNA2",7,6,1,0,1
"CIDEA",7,2,5,0,1
"CNGB1",11,1,10,0,1
"RHO",18,8,10,0,1
"CNGB3",6,3,3,0,1
"PTP4A1",6,3,3,0,1
"COL12A1",10,4,6,0,1
"FKBP10",7,4,3,0,1
"CORT",4,3,1,0,1
"MT-CO1",16,4,12,0,1
"MT-CYB",18,5,13,0,1
"CP",8,3,5,0,1
"NCBP2",37,19,18,0,1
"CRHR1",13,8,5,0,1
"TAC1",22,8,14,0,1
"S100A8",14,6,8,0,1
"SLC17A8",8,5,3,0,1
"DVL1",24,20,4,0,1
"LRP6",20,2,18,0,1
"WNT1",26,14,12,0,1
"GPC3",19,13,6,0,1
"WNT2B",21,16,5,0,1
"CYP1A1",20,12,8,0,1
"CYP4A11",17,5,12,0,1
"CYP2D6",5,2,3,0,1
"XPO5",9,2,7,0,1
"TIGD4",4,2,2,0,1
"LSM8",18,4,14,0,1
"GBA",9,4,5,0,1
"RPL11",85,50,35,0,1
"WNT10B",16,10,6,0,1
"WNT4",19,8,11,0,1
"PQLC1",3,2,1,0,1
"LHX6",6,3,3,0,1
"HSPA13",14,4,10,0,1
"GABRA1",16,13,3,0,1
"DOCK11",2,1,1,0,1
"XPNPEP2",5,4,1,0,1
"GNB3",22,1,21,0,1
"PKP1",7,5,2,0,1
"PKP3",11,7,4,0,1
"PARP9",6,4,2,0,1
"MAPK11",49,19,30,0,1
"MAPK3",70,10,60,0,1
"PTPRR",7,3,4,0,1
"DYNLT1",12,4,8,0,1
"TFDP1",21,7,14,0,1
"PAX5",9,5,4,0,1
"IL12RB2",4,1,3,0,1
"HNRNPA1",40,19,21,0,1
"ENO4",7,3,4,0,1
"EFNA3",11,5,6,0,1
"PRKCZ",32,24,8,0,1
"EGR4",4,3,1,0,1
"EIF4A1",64,10,54,0,1
"PASK",4,3,1,0,1
"SPINT2",8,2,6,0,1
"FGFR3",11,8,3,0,1
"ESPN",4,2,2,0,1
"EZH2",42,8,34,0,1
"NCOA3",14,7,7,0,1
"F12",7,1,6,0,1
"F5",6,4,2,0,1
"MB",5,4,1,0,1
"FADS2",4,1,3,0,1
"FAM110A",2,1,1,0,1
"GPANK1",3,1,2,0,1
"SND1",8,4,4,0,1
"GABRA6",13,3,10,0,1
"SPAG17",5,1,4,0,1
"TRIM21",8,1,7,0,1
"TPH2",5,2,3,0,1
"PLAU",16,9,7,0,1
"FOXN4",2,1,1,0,1
"FUT1",6,1,5,0,1
"GPC4",17,12,5,0,1
"HK2",12,4,8,0,1
"HKDC1",5,3,2,0,1
"GAB1",22,3,19,0,1
"MAP1LC3A",4,3,1,0,1
"NBR1",4,2,2,0,1
"GABRA5",14,7,7,0,1
"SLC6A13",3,2,1,0,1
"SULT4A1",4,1,3,0,1
"GLDC",6,5,1,0,1
"GALR2",3,2,1,0,1
"HPRT1",5,1,4,0,1
"NOG",8,2,6,0,1
"GIMAP8",3,2,1,0,1
"GNRH1",11,4,7,0,1
"GPC2",15,4,11,0,1
"GPX7",10,6,4,0,1
"SPRTN",7,3,4,0,1
"SHANK1",19,3,16,0,1
"GSTO2",8,3,5,0,1
"TNPO1",15,4,11,0,1
"HCRTR1",2,1,1,0,1
"HAS2",5,2,3,0,1
"HENMT1",8,4,4,0,1
"SP1",29,7,22,0,1
"MAPKAPK2",13,7,6,0,1
"ID3",6,3,3,0,1
"NOD2",22,5,17,0,1
"PAPSS1",5,1,4,0,1
"PLCH1",5,2,3,0,1
"SLC30A10",7,3,4,0,1
"NFATC2",4,2,2,0,1
"IVL",9,7,2,0,1
"KCNAB2",26,18,8,0,1
"KCNJ10",5,3,2,0,1
"KLC3",11,5,6,0,1
"KLF5",3,1,2,0,1
"KLHL9",9,5,4,0,1
"TMA16",22,9,13,0,1
"ULBP2",3,2,1,0,1
"KMO",3,2,1,0,1
"RGPD2",8,7,1,0,1
"LHX3",4,3,1,0,1
"SNAP25",68,8,60,0,1
"LMX1B",4,1,3,0,1
"TMEM86B",3,2,1,0,1
"LY6H",2,1,1,0,1
"TLX1",4,1,3,0,1
"PRKAR2B",17,3,14,0,1
"RCSD1",2,1,1,0,1
"RRM2B",18,2,16,0,1
"METTL1",13,7,6,0,1
"MRC2",2,1,1,0,1
"MRPL24",36,15,21,0,1
"WFIKKN2",2,1,1,0,1
"SMPX",6,2,4,0,1
"SPDEF",3,1,2,0,1
"RSPO1",5,3,2,0,1
"ST3GAL3",10,2,8,0,1
"NRBP2",2,1,1,0,1
"OPN3",3,2,1,0,1
"TP53",151,5,146,0,1
"PGAP1",4,1,3,0,1
"SYT3",10,6,4,0,1
"PPP2R2C",6,2,4,0,1
"SCNN1A",12,4,8,0,1
"TRMT5",4,2,2,0,1
"SGSM2",5,3,2,0,1
"RPN2",23,2,21,0,1
"RNASE2",5,2,3,0,1
"RSPO2",5,1,4,0,1
"SCNN1G",13,3,10,0,1
"SIX3",4,1,3,0,1
"SLC39A14",8,3,5,0,1
"SYNPR",7,6,1,0,1
"UBE2H",7,3,4,0,1
"WNT10A",16,2,14,0,1
"ZNF827",3,1,2,0,1
