"Name","K","Kin","Kout","TypeI","TypeII"
"MUCL1",15,2,13,0,1
"AP1G1",22,17,5,0,1
"MARS2",18,6,12,0,1
"UBA1",21,11,10,0,1
"TMEM126A",7,4,3,0,1
"ABAT",13,9,4,0,1
"ABCA1",16,14,2,0,1
"ABCA2",7,3,4,0,1
"ABCA3",2,1,1,0,1
"FXN",17,14,3,0,1
"GLRX5",14,10,4,0,1
"IBA57",10,8,2,0,1
"NFS1",15,11,4,0,1
"ABCC2",9,5,4,0,1
"PDZK1",21,18,3,0,1
"RDX",11,7,4,0,1
"UGT1A1",14,10,4,0,1
"ALB",63,21,42,0,1
"PRKACB",48,40,8,0,1
"SLC2A2",10,6,4,0,1
"HACL1",16,11,5,0,1
"ACTB",77,49,28,0,1
"BBS10",39,26,13,0,1
"EIF1AX",34,19,15,0,1
"G3BP1",20,10,10,0,1
"HBS1L",14,11,3,0,1
"PA2G4",64,17,47,0,1
"PES1",58,31,27,0,1
"RPL24",54,35,19,0,1
"RPL4",71,30,41,0,1
"RPS21",48,20,28,0,1
"RPS3A",87,45,42,0,1
"RUVBL1",69,35,34,0,1
"DDB1",51,14,37,0,1
"EEF1G",65,22,43,0,1
"BMI1",17,7,10,0,1
"ABHD2",2,1,1,0,1
"OSBPL1A",6,3,3,0,1
"PRKAA1",25,12,13,0,1
"PRKAA2",21,15,6,0,1
"ETFB",16,7,9,0,1
"HADHB",22,10,12,0,1
"AOX1",30,22,8,0,1
"ARF6",34,16,18,0,1
"HADHA",13,9,4,0,1
"ACBD5",11,7,4,0,1
"SGMS1",11,7,4,0,1
"EGFR",73,19,54,0,1
"KMO",7,5,2,0,1
"AGXT",28,13,15,0,1
"ALDOA",21,17,4,0,1
"CAT",32,6,26,0,1
"CYCS",73,34,39,0,1
"GPD1L",5,2,3,0,1
"GPI",26,25,1,0,1
"MDH2",66,38,28,0,1
"PDHB",42,18,24,0,1
"PKM",36,12,24,0,1
"SDHA",52,14,38,0,1
"ACOT4",11,7,4,0,1
"PFKM",20,11,9,0,1
"SCP2",19,13,6,0,1
"ACTA1",34,23,11,0,1
"CDC42",100,76,24,0,1
"EZR",32,16,16,0,1
"CTGF",12,8,4,0,1
"PGK1",19,11,8,0,1
"RAD23B",38,27,11,0,1
"SQSTM1",35,31,4,0,1
"TRRAP",23,20,3,0,1
"CTNNB1",162,99,63,0,1
"LDB3",12,9,3,0,1
"NPHS1",13,9,4,0,1
"NPHS2",8,4,4,0,1
"PTK2",69,34,35,0,1
"RAC1",83,38,45,0,1
"SPTAN1",12,9,3,0,1
"DNAH8",15,5,10,0,1
"HSP90AA1",115,68,47,0,1
"FCGR3A",22,11,11,0,1
"ARPC1A",8,5,3,0,1
"ACVR1",10,2,8,0,1
"CUL1",53,26,27,0,1
"NEO1",8,5,3,0,1
"BACE1",16,7,9,0,1
"PSEN1",29,17,12,0,1
"BTC",11,7,4,0,1
"TNF",54,50,4,0,1
"CNTNAP2",7,4,3,0,1
"YWHAB",43,27,16,0,1
"COQ3",5,1,4,0,1
"ADCY1",13,3,10,0,1
"ADCY4",13,5,8,0,1
"CAMK2B",23,18,5,0,1
"ENPP3",26,22,4,0,1
"GNAS",36,25,11,0,1
"PRKCD",27,21,6,0,1
"ADCY2",12,5,7,0,1
"GNG4",11,9,2,0,1
"ADH1B",15,7,8,0,1
"ADH5",17,6,11,0,1
"LDHB",21,19,2,0,1
"PNPLA4",4,2,2,0,1
"ADIPOR1",3,2,1,0,1
"TXNL4A",8,2,6,0,1
"NPY",17,16,1,0,1
"BSG",16,8,8,0,1
"ASRGL1",6,5,1,0,1
"ASS1",16,11,5,0,1
"TFPI",9,1,8,0,1
"NUP98",40,20,20,0,1
"MLLT3",11,4,7,0,1
"NCBP1",50,32,18,0,1
"SGIP1",13,8,5,0,1
"AGER",8,6,2,0,1
"LTB4R",3,2,1,0,1
"AGMO",4,3,1,0,1
"AGPAT4",8,3,5,0,1
"PPAP2C",13,10,3,0,1
"GLDC",15,13,2,0,1
"PIPOX",18,8,10,0,1
"ALAS2",13,6,7,0,1
"UPB1",9,3,6,0,1
"CAV1",41,21,20,0,1
"ESR1",18,14,4,0,1
"RSF1",13,9,4,0,1
"HSPA4",68,31,37,0,1
"TSFM",13,3,10,0,1
"NTPCR",12,7,5,0,1
"MAPRE1",15,8,7,0,1
"MLST8",25,22,3,0,1
"B2M",25,24,1,0,1
"CASP3",32,10,22,0,1
"DPP4",20,14,6,0,1
"F3",16,11,5,0,1
"OCLN",26,12,14,0,1
"PLG",37,19,18,0,1
"SERPINC1",33,27,6,0,1
"GGT6",7,5,2,0,1
"ALG1",6,1,5,0,1
"ALG8",9,3,6,0,1
"DPM1",17,9,8,0,1
"RPN1",33,10,23,0,1
"GANAB",11,7,4,0,1
"CYP2B6",25,11,14,0,1
"CYP2C8",21,12,9,0,1
"CYP2J2",13,8,5,0,1
"CYP4A22",22,16,6,0,1
"PTGS1",15,12,3,0,1
"SLC30A6",11,7,4,0,1
"FTCD",22,8,14,0,1
"SYVN1",15,11,4,0,1
"UBL4A",7,4,3,0,1
"UBR1",5,4,1,0,1
"VCP",65,45,20,0,1
"HPRT1",15,5,10,0,1
"AMPH",16,6,10,0,1
"AP1B1",8,3,5,0,1
"SACM1L",21,18,3,0,1
"NTRK1",33,28,5,0,1
"MET",48,22,26,0,1
"KCNQ2",19,14,5,0,1
"NFASC",11,6,5,0,1
"SCN8A",12,7,5,0,1
"ITPR2",15,10,5,0,1
"ANKMY2",3,1,2,0,1
"CHM",35,19,16,0,1
"CHML",33,21,12,0,1
"FAM63A",2,1,1,0,1
"TTC30A",5,2,3,0,1
"CDK1",137,116,21,0,1
"KIF2C",79,54,25,0,1
"TTK",77,51,26,0,1
"UBE2C",73,40,33,0,1
"ANPEP",19,8,11,0,1
"GOT1",21,15,6,0,1
"PROM1",15,11,4,0,1
"ATP6V1H",45,27,18,0,1
"CAMK2D",21,10,11,0,1
"KSR1",20,18,2,0,1
"OCRL",31,18,13,0,1
"PREP",3,2,1,0,1
"CNTN1",9,8,1,0,1
"TMED10",51,16,35,0,1
"CAMP",6,4,2,0,1
"APOOL",15,11,4,0,1
"CALR",27,17,10,0,1
"LRRK2",28,6,22,0,1
"MAPK10",27,13,14,0,1
"UBQLN1",17,13,4,0,1
"EEA1",23,9,14,0,1
"CRNKL1",17,14,3,0,1
"SF3B3",28,10,18,0,1
"SNRPB",37,30,7,0,1
"C3orf58",12,4,8,0,1
"COPA",30,18,12,0,1
"COPG1",29,16,13,0,1
"COPG2",24,18,6,0,1
"KDELR1",23,13,10,0,1
"SEC23B",17,8,9,0,1
"RAB1B",32,15,17,0,1
"FN1",55,37,18,0,1
"ROCK1",20,15,5,0,1
"ATRX",5,2,3,0,1
"GRIP1",7,5,2,0,1
"KIF5B",15,5,10,0,1
"ARMC1",3,1,2,0,1
"MORN5",4,2,2,0,1
"MYO5A",19,16,3,0,1
"ASB15",3,2,1,0,1
"CUL5",20,11,9,0,1
"POLA1",48,36,12,0,1
"CDT1",42,18,24,0,1
"SLC22A1",8,6,2,0,1
"NCOA6",12,4,8,0,1
"PRMT1",19,16,3,0,1
"RNF2",34,17,17,0,1
"GAD1",23,10,13,0,1
"INTS5",10,3,7,0,1
"CREB3L2",4,1,3,0,1
"ATG3",22,9,13,0,1
"ATG7",32,23,9,0,1
"MAP1LC3C",8,6,2,0,1
"PIK3R4",28,20,8,0,1
"UVRAG",17,13,4,0,1
"EPG5",8,4,4,0,1
"WIPI2",9,4,5,0,1
"PINK1",36,30,6,0,1
"RAB7B",6,5,1,0,1
"UBE2H",17,13,4,0,1
"TMEM30B",6,5,1,0,1
"ATP5C1",47,30,17,0,1
"ATP5F1",54,41,13,0,1
"ATP5G3",48,13,35,0,1
"ATP6V1C1",32,26,6,0,1
"EEF2",59,16,43,0,1
"NDUFA12",66,36,30,0,1
"NDUFV1",61,34,27,0,1
"NDUFB8",57,21,36,0,1
"UQCR10",63,38,25,0,1
"UQCRQ",71,49,22,0,1
"NDUFA1",61,38,23,0,1
"CHCHD2",18,16,2,0,1
"TMEM165",5,3,2,0,1
"RRAGD",21,12,9,0,1
"PRDX2",9,6,3,0,1
"AUH",9,5,4,0,1
"GINS2",52,9,43,0,1
"PPP1CC",57,33,24,0,1
"B4GALT1",21,15,6,0,1
"SDC2",24,11,13,0,1
"FMOD",17,10,7,0,1
"OMD",13,10,3,0,1
"PRELP",14,8,6,0,1
"MGAT5B",3,1,2,0,1
"DCN",24,1,23,0,1
"SDC4",30,18,12,0,1
"RTN4",8,2,6,0,1
"EPS8",6,4,2,0,1
"PPP2R1A",41,14,27,0,1
"SNRPD2",45,21,24,0,1
"XCR1",20,9,11,0,1
"PSMC2",50,40,10,0,1
"BDP1",10,6,4,0,1
"RMI1",22,12,10,0,1
"BLK",19,3,16,0,1
"MAPK11",30,13,17,0,1
"TRPV6",8,5,3,0,1
"BRCC3",16,9,7,0,1
"POLR2K",31,16,15,0,1
"BSND",2,1,1,0,1
"COPS2",31,8,23,0,1
"COPS4",31,3,28,0,1
"CLSPN",29,15,14,0,1
"MRPL17",34,8,26,0,1
"DHCR7",14,10,4,0,1
"C1GALT1C1",12,3,9,0,1
"SLC39A9",8,3,5,0,1
"C1QB",17,6,11,0,1
"CYP24A1",8,1,7,0,1
"CALM3",27,7,20,0,1
"GRIA2",18,7,11,0,1
"MBP",9,8,1,0,1
"PHKB",6,4,2,0,1
"DEFB1",2,1,1,0,1
"PDIA3",26,10,16,0,1
"TOR1A",10,6,4,0,1
"CAPN3",5,4,1,0,1
"DDX3X",27,20,7,0,1
"FMR1",20,7,13,0,1
"EIF4G2",12,11,1,0,1
"LIMK1",9,3,6,0,1
"PTPN11",50,28,22,0,1
"SMURF1",15,9,6,0,1
"CBR3",9,2,7,0,1
"UGT1A9",14,9,5,0,1
"SUZ12",29,16,13,0,1
"CFAP43",8,2,6,0,1
"CCDC186",5,4,1,0,1
"HEPACAM2",2,1,1,0,1
"PLEKHS1",2,1,1,0,1
"SEC61A1",57,4,53,0,1
"CCR10",7,3,4,0,1
"CXCL9",18,11,7,0,1
"IL1B",43,11,32,0,1
"CCL2",31,7,24,0,1
"TSLP",7,5,2,0,1
"CX3CR1",10,4,6,0,1
"LEP",15,8,7,0,1
"PF4",6,3,3,0,1
"VCAM1",14,6,8,0,1
"CDK4",23,5,18,0,1
"SMC1A",29,17,12,0,1
"PSMD2",44,17,27,0,1
"PSMF1",21,10,11,0,1
"POLR2B",44,31,13,0,1
"CCT5",54,14,40,0,1
"TUBA1C",17,10,7,0,1
"KIT",35,9,26,0,1
"HLA-DPA1",15,11,4,0,1
"CD86",19,6,13,0,1
"PDCD1",8,3,5,0,1
"TLR7",8,5,3,0,1
"MGRN1",7,2,5,0,1
"UBE2N",48,16,32,0,1
"DCC",12,7,5,0,1
"CLDN4",6,4,2,0,1
"IGF1",30,17,13,0,1
"RAPGEF1",13,10,3,0,1
"NTRK2",25,6,19,0,1
"PTPRS",9,4,5,0,1
"LGALS3",15,1,14,0,1
"DCAF13",63,19,44,0,1
"SDAD1",48,31,17,0,1
"NPM1",28,8,20,0,1
"MEST",5,1,4,0,1
"CFAP45",3,1,2,0,1
"WDR66",6,4,2,0,1
"CFHR1",9,1,8,0,1
"NIPA1",6,3,3,0,1
"KCNJ1",8,6,2,0,1
"PRSS1",7,3,4,0,1
"PSMB8",9,3,6,0,1
"RAB11A",39,8,31,0,1
"TIMM8A",23,14,9,0,1
"SYT2",8,5,3,0,1
"PAFAH2",7,5,2,0,1
"GREM2",4,2,2,0,1
"PAK3",19,11,8,0,1
"GAMT",12,10,2,0,1
"MYOZ1",7,4,3,0,1
"POP4",6,5,1,0,1
"DNA2",29,12,17,0,1
"USP7",23,14,9,0,1
"CNDP1",10,5,5,0,1
"PTPRZ1",4,2,2,0,1
"COL4A5",9,5,4,0,1
"COPS6",27,10,17,0,1
"DCAF11",17,14,3,0,1
"PPTC7",5,4,1,0,1
"CPN2",2,1,1,0,1
"DCLRE1A",9,8,1,0,1
"MED1",31,13,18,0,1
"CSE1L",14,5,9,0,1
"XPOT",18,6,12,0,1
"CSTF1",9,2,7,0,1
"DDX1",7,5,2,0,1
"SMAD4",31,7,24,0,1
"ZCRB1",10,2,8,0,1
"CTLA4",18,6,12,0,1
"GFRA1",9,4,5,0,1
"MAGI2",9,4,5,0,1
"CTSD",11,2,9,0,1
"KDM2B",3,2,1,0,1
"HCCS",5,3,2,0,1
"SLC25A6",11,9,2,0,1
"CYLD",9,7,2,0,1
"CYP11A1",9,1,8,0,1
"LIPA",3,2,1,0,1
"CYP1A2",17,11,6,0,1
"FDX1",10,1,9,0,1
"CYP2C9",31,7,24,0,1
"CYP4A11",26,10,16,0,1
"CYP2D6",8,4,4,0,1
"PRPF31",37,21,16,0,1
"MSTN",11,3,8,0,1
"TMPRSS6",10,7,3,0,1
"EDC3",8,4,4,0,1
"ERCC4",34,15,19,0,1
"SRPRB",21,17,4,0,1
"NXF3",3,2,1,0,1
"DFNB31",6,3,3,0,1
"PCDH15",7,3,4,0,1
"DHRS2",2,1,1,0,1
"EIF2S1",56,6,50,0,1
"S100A14",5,1,4,0,1
"DLG3",16,7,9,0,1
"NRXN1",17,14,3,0,1
"NLGN3",9,4,5,0,1
"RAD52",23,15,8,0,1
"XRCC2",14,8,6,0,1
"XRCC6",39,28,11,0,1
"PPME1",5,3,2,0,1
"GIPC1",6,4,2,0,1
"DPYD",7,4,3,0,1
"KLHL12",17,7,10,0,1
"ZCCHC4",4,2,2,0,1
"RPS2",56,24,32,0,1
"TTC7B",3,1,2,0,1
"FGFR3",17,10,7,0,1
"NTRK3",13,6,7,0,1
"NAT10",50,11,39,0,1
"ENOPH1",9,2,7,0,1
"NPTN",3,1,2,0,1
"ESR2",15,1,14,0,1
"NCOR2",18,11,7,0,1
"SNAP25",23,4,19,0,1
"HS2ST1",11,5,6,0,1
"NDST1",7,1,6,0,1
"UXS1",4,2,2,0,1
"FAHD1",4,3,1,0,1
"PEX26",9,3,6,0,1
"FLNC",10,2,8,0,1
"MYBPC1",7,3,4,0,1
"HNF4A",14,5,9,0,1
"SNAI2",4,2,2,0,1
"FOXO1",19,8,11,0,1
"GPSM2",3,2,1,0,1
"TBC1D5",11,6,5,0,1
"TAC1",15,3,12,0,1
"PKLR",21,6,15,0,1
"GPHN",6,3,3,0,1
"GATA1",4,2,2,0,1
"HNF1A",11,1,10,0,1
"TM6SF2",6,5,1,0,1
"HTRA4",2,1,1,0,1
"IMMP2L",3,2,1,0,1
"SLC19A1",3,2,1,0,1
"PSMB5",26,18,8,0,1
"SHH",25,5,20,0,1
"VAPA",17,10,7,0,1
"PDE11A",5,1,4,0,1
"PAK2",35,13,22,0,1
"VPS35",31,8,23,0,1
"SIAH1",6,3,3,0,1
"HECTD1",2,1,1,0,1
"MSH5",8,5,3,0,1
"HNRNPH2",8,6,2,0,1
"NRG4",9,5,4,0,1
"NAA15",9,3,6,0,1
"TLR3",10,3,7,0,1
"IL17RB",3,1,2,0,1
"MARVELD2",7,3,4,0,1
"INPP5J",6,2,4,0,1
"SGK1",13,8,5,0,1
"VHL",14,1,13,0,1
"KCNAB2",10,8,2,0,1
"KCNJ11",6,3,3,0,1
"KLHL22",7,5,2,0,1
"KHDRBS2",3,1,2,0,1
"MAPRE2",7,3,4,0,1
"METTL14",12,6,6,0,1
"KIAA1715",5,2,3,0,1
"RAPGEF2",7,2,5,0,1
"POU5F1",20,3,17,0,1
"STK39",9,5,4,0,1
"WNK3",12,4,8,0,1
"RRP8",23,4,19,0,1
"SLC17A5",2,1,1,0,1
"PGM5",8,5,3,0,1
"LEMD3",4,3,1,0,1
"PNISR",7,2,5,0,1
"PLXNA4",5,3,2,0,1
"RPL37",43,8,35,0,1
"PNPLA7",6,5,1,0,1
"LRPAP1",6,5,1,0,1
"LRRN2",2,1,1,0,1
"USP9X",14,4,10,0,1
"PPARG",22,1,21,0,1
"TCF12",8,6,2,0,1
"SNRNP25",8,4,4,0,1
"SAE1",11,5,6,0,1
"MRPL3",47,7,40,0,1
"NAA35",8,4,4,0,1
"PIP",2,1,1,0,1
"RCN2",4,2,2,0,1
"NRXN2",18,2,16,0,1
"NSMCE2",9,4,5,0,1
"NTN1",17,1,16,0,1
"SYNE1",4,2,2,0,1
"WT1",12,2,10,0,1
"PCSK2",2,1,1,0,1
"UXT",8,4,4,0,1
"PIAS1",11,1,10,0,1
"PPP1CA",9,2,7,0,1
"WNT8B",18,10,8,0,1
"USP14",22,7,15,0,1
"SLITRK2",2,1,1,0,1
"PURB",2,1,1,0,1
"TRAPPC11",9,6,3,0,1
"TRAPPC6B",12,3,9,0,1
"YIPF5",5,1,4,0,1
"SRP9",15,2,13,0,1
"S100A3",3,2,1,0,1
"WNT10B",10,3,7,0,1
"SNTG2",6,2,4,0,1
"SLC15A1",9,5,4,0,1
"SLC34A1",7,2,5,0,1
"SLC1A1",7,1,6,0,1
"SLC6A19",8,3,5,0,1
"SLC29A2",3,1,2,0,1
"SLC30A2",5,3,2,0,1
"SLC39A7",7,3,4,0,1
"SLC39A3",2,1,1,0,1
"SLC6A3",10,2,8,0,1
"TCEAL6",2,1,1,0,1
"TMTC4",4,1,3,0,1
"TMED5",11,8,3,0,1
"TRPV5",7,2,5,0,1
"TSPAN32",2,1,1,0,1
"UBE3C",5,2,3,0,1
"ZNF397",3,1,2,0,1
