"Name","K","Kin","Kout","TypeI","TypeII"
"KLK6",3,2,1,0,1
"PPL",12,5,7,0,1
"YWHAZ",40,33,7,0,1
"MGP",3,1,2,0,1
"SLC4A1",6,2,4,0,1
"PHGDH",11,6,5,0,1
"ACHE",8,2,6,0,1
"GHRL",14,9,5,0,1
"NGF",30,18,12,0,1
"CXCL11",24,10,14,0,1
"IDH2",12,6,6,0,1
"ACOT7",3,2,1,0,1
"DCDC2",4,3,1,0,1
"ACOT4",9,3,6,0,1
"DDO",8,6,2,0,1
"ACPP",3,2,1,0,1
"LAMB3",28,23,5,0,1
"ACTB",110,62,48,0,1
"B2M",44,41,3,0,1
"CDC42",92,71,21,0,1
"CHEK1",90,78,12,0,1
"H3F3A",23,16,7,0,1
"LMNA",13,8,5,0,1
"MAP1LC3A",9,5,4,0,1
"MEAF6",9,5,4,0,1
"MMP9",52,33,19,0,1
"MYH10",21,9,12,0,1
"PROM1",13,9,4,0,1
"XIAP",23,16,7,0,1
"CTNNB1",118,72,46,0,1
"ITGB6",22,11,11,0,1
"SDC4",33,20,13,0,1
"ADAMTS1",18,4,14,0,1
"ADAMTS14",18,14,4,0,1
"ADAMTSL4",15,10,5,0,1
"POFUT2",14,7,7,0,1
"THBS2",29,19,10,0,1
"MMP3",30,10,20,0,1
"PDE6C",8,6,2,0,1
"ADCY4",12,5,7,0,1
"PDE1A",8,7,1,0,1
"ADCY8",17,3,14,0,1
"PKM",32,12,20,0,1
"ADCYAP1",12,10,2,0,1
"ADH1B",14,5,9,0,1
"ADSS",15,7,8,0,1
"ENTPD3",18,8,10,0,1
"PNP",9,6,3,0,1
"SFTPC",11,5,6,0,1
"NPPA",8,4,4,0,1
"GGCT",5,1,4,0,1
"AGER",9,7,2,0,1
"ITGB2",52,45,7,0,1
"AGMO",6,4,2,0,1
"AGPAT2",7,6,1,0,1
"LPPR3",6,5,1,0,1
"MBOAT2",13,4,9,0,1
"CYP1A2",21,11,10,0,1
"STAT1",43,5,38,0,1
"CYP1A1",23,16,7,0,1
"KRT17",6,4,2,0,1
"FHL2",8,4,4,0,1
"AKR1C3",13,8,5,0,1
"DHRS9",13,11,2,0,1
"ALB",44,18,26,0,1
"CSF2",41,17,24,0,1
"CXCL8",59,22,37,0,1
"DPP4",22,16,6,0,1
"FN1",86,56,30,0,1
"GPT",7,5,2,0,1
"HP",23,13,10,0,1
"PLG",28,14,14,0,1
"POMC",35,32,3,0,1
"CYP2C8",16,9,7,0,1
"PC",13,7,6,0,1
"ALK",16,11,5,0,1
"CYP2J2",10,4,6,0,1
"ALOX15B",10,6,4,0,1
"ALOX5",18,10,8,0,1
"GDI2",14,10,4,0,1
"GLI3",7,3,4,0,1
"HPX",10,6,4,0,1
"CD3D",21,7,14,0,1
"UBB",74,23,51,0,1
"CYP17A1",13,5,8,0,1
"GNRH1",12,5,7,0,1
"AMPH",12,4,8,0,1
"FTCD",14,8,6,0,1
"OCA2",5,2,3,0,1
"MGAM",6,5,1,0,1
"KCNQ2",20,11,9,0,1
"RYR2",19,13,6,0,1
"TCAP",26,9,17,0,1
"AURKB",98,50,48,0,1
"BUB1",111,48,63,0,1
"CDK1",150,121,29,0,1
"DIAPH3",16,12,4,0,1
"SEPT9",4,2,2,0,1
"SHCBP1",43,21,22,0,1
"TYMS",79,43,36,0,1
"CD2",29,21,8,0,1
"FCGR1A",28,18,10,0,1
"SFN",27,18,9,0,1
"ANXA2",19,10,9,0,1
"NCSTN",14,5,9,0,1
"PSEN1",29,13,16,0,1
"CLU",20,11,9,0,1
"SDC1",44,36,8,0,1
"SPINK5",8,3,5,0,1
"CFH",14,4,10,0,1
"PLAUR",23,13,10,0,1
"PLIN1",11,4,7,0,1
"ARF6",30,14,16,0,1
"GRIA1",29,25,4,0,1
"ITGA8",24,16,8,0,1
"MET",42,18,24,0,1
"DNER",6,2,4,0,1
"ARHGDIB",9,3,6,0,1
"NPAS2",6,4,2,0,1
"FCGR3A",35,17,18,0,1
"PSMB2",28,17,11,0,1
"ARSD",3,2,1,0,1
"ASCL1",6,3,3,0,1
"DLX1",4,2,2,0,1
"CHAF1A",16,9,7,0,1
"HIST1H4J",25,9,16,0,1
"PCNA",77,57,20,0,1
"RRM1",46,19,27,0,1
"GLUD2",12,4,8,0,1
"RIMKLB",7,3,4,0,1
"CKS2",52,40,12,0,1
"RBBP8",25,19,6,0,1
"CBX8",16,3,13,0,1
"ATP6AP1",13,9,4,0,1
"COA6",14,8,6,0,1
"NDUFA13",17,14,3,0,1
"NDUFA4",16,7,9,0,1
"NDUFB2",15,12,3,0,1
"NDUFS5",19,12,7,0,1
"ROMO1",8,5,3,0,1
"PPP1CA",38,18,20,0,1
"SCARF1",6,1,5,0,1
"GSK3B",39,21,18,0,1
"B3GALT2",5,1,4,0,1
"GPC2",14,5,9,0,1
"FUT3",5,2,3,0,1
"MUC15",18,15,3,0,1
"MUC21",24,12,12,0,1
"PRELP",8,7,1,0,1
"CHST6",6,3,3,0,1
"B4GALNT1",8,6,2,0,1
"B4GALNT2",2,1,1,0,1
"GBA",14,7,7,0,1
"GLB1",17,5,12,0,1
"ST3GAL5",5,3,2,0,1
"CSAD",4,1,3,0,1
"PECR",8,2,6,0,1
"SYTL4",3,2,1,0,1
"PPP2R1A",30,13,17,0,1
"PAX9",3,2,1,0,1
"SDC3",25,9,16,0,1
"BLOC1S2",5,3,2,0,1
"NAGA",5,4,1,0,1
"BCL10",4,1,3,0,1
"HSPA4",47,26,21,0,1
"ITPR1",24,6,18,0,1
"HIST1H2BK",31,15,16,0,1
"PRDM8",2,1,1,0,1
"BLM",42,19,23,0,1
"RTEL1",14,8,6,0,1
"FYN",80,40,40,0,1
"BPGM",5,4,1,0,1
"XRCC4",11,9,2,0,1
"BSCL2",4,2,2,0,1
"SPN",19,11,8,0,1
"RPS14",70,46,24,0,1
"RPS6",71,40,31,0,1
"BUD31",14,12,2,0,1
"SNRPB",30,25,5,0,1
"CA7",2,1,1,0,1
"SYCE1",4,1,3,0,1
"C1GALT1C1",17,3,14,0,1
"C1QB",22,9,13,0,1
"CACNA1B",10,9,1,0,1
"CACNA1H",17,8,9,0,1
"PPP1CB",28,19,9,0,1
"EFHC1",3,2,1,0,1
"LRIT3",3,2,1,0,1
"GRIA2",24,11,13,0,1
"GRIA4",14,5,9,0,1
"CADM1",8,5,3,0,1
"PPIB",7,2,5,0,1
"CAPG",2,1,1,0,1
"CRIP1",2,1,1,0,1
"CCDC42",2,1,1,0,1
"MYCBPAP",4,3,1,0,1
"RBM44",4,2,2,0,1
"CCDC96",2,1,1,0,1
"PSMD14",31,28,3,0,1
"CCL7",21,16,5,0,1
"CCNB1",119,16,103,0,1
"TGFBR2",13,10,3,0,1
"CDH2",17,4,13,0,1
"PSMB8",40,21,19,0,1
"CD86",40,20,20,0,1
"RPS2",72,28,44,0,1
"RPS3A",70,29,41,0,1
"CD14",14,6,8,0,1
"STAB1",6,3,3,0,1
"KIT",37,14,23,0,1
"PRKCG",8,3,5,0,1
"IL2RG",22,15,7,0,1
"GZMA",9,4,5,0,1
"HLA-DQA1",24,7,17,0,1
"ITGA2",39,16,23,0,1
"CD9",17,12,5,0,1
"CLDN3",7,5,2,0,1
"FGFR1",30,24,6,0,1
"GFRA1",8,4,4,0,1
"IGF1",54,24,30,0,1
"JUP",25,20,5,0,1
"NTRK2",29,5,24,0,1
"CDSN",5,4,1,0,1
"CEL",8,6,2,0,1
"CFAP69",6,3,3,0,1
"CHL1",7,1,6,0,1
"ST8SIA2",4,1,3,0,1
"CHMP4C",15,4,11,0,1
"GREM2",5,2,3,0,1
"LAMC3",16,8,8,0,1
"LPAR1",9,6,3,0,1
"PAK3",15,6,9,0,1
"LAMA3",34,19,15,0,1
"CHRNA4",7,6,1,0,1
"RIC3",4,2,2,0,1
"COL9A3",6,3,3,0,1
"TRPM6",3,2,1,0,1
"PRPF39",16,9,7,0,1
"KDELR1",6,4,2,0,1
"ELN",19,12,7,0,1
"CNR1",7,3,4,0,1
"P4HA2",25,22,3,0,1
"LUM",19,5,14,0,1
"PCOLCE2",5,1,4,0,1
"PLOD2",10,2,8,0,1
"COL6A1",15,11,4,0,1
"SOCS1",15,11,4,0,1
"CORT",2,1,1,0,1
"MT-CO1",15,4,11,0,1
"SRSF11",11,8,3,0,1
"PRICKLE1",10,4,6,0,1
"LAMP2",7,5,2,0,1
"S100A8",8,4,4,0,1
"DCK",21,5,16,0,1
"LGR5",7,2,5,0,1
"TMPRSS6",8,5,3,0,1
"DEGS2",9,2,7,0,1
"NLGN1",12,6,6,0,1
"HSPA13",6,2,4,0,1
"RAB27A",8,5,3,0,1
"DPH5",5,3,2,0,1
"ESPN",6,3,3,0,1
"DUSP6",2,1,1,0,1
"PTPRR",5,3,2,0,1
"PAX5",12,6,6,0,1
"IL27RA",7,2,5,0,1
"EIF4B",11,10,1,0,1
"EFNA3",9,6,3,0,1
"EFNA5",12,3,9,0,1
"MRPL17",36,8,28,0,1
"FGF7",15,8,7,0,1
"PIK3CB",32,14,18,0,1
"IRF4",15,7,8,0,1
"NPM1",26,6,20,0,1
"MFAP5",8,5,3,0,1
"HK2",12,3,9,0,1
"F10",7,4,3,0,1
"MED29",8,3,5,0,1
"MLKL",3,2,1,0,1
"SOWAHB",3,2,1,0,1
"GABRA6",6,2,4,0,1
"MNDA",9,6,3,0,1
"MASP1",9,3,6,0,1
"FGF10",11,5,6,0,1
"SERPINF2",8,3,5,0,1
"FLNC",13,5,8,0,1
"UNC5A",4,3,1,0,1
"UNC5B",4,1,3,0,1
"ITGA10",12,8,4,0,1
"PNISR",14,8,6,0,1
"FREM1",3,2,1,0,1
"PTK2B",14,10,4,0,1
"GABBR1",5,3,2,0,1
"NLRP3",13,5,8,0,1
"TKTL1",5,4,1,0,1
"LENG8",3,1,2,0,1
"HTR3A",7,4,3,0,1
"ORMDL3",5,3,2,0,1
"HDC",4,1,3,0,1
"HAND2",3,1,2,0,1
"NKX3-2",3,2,1,0,1
"TM6SF2",3,2,1,0,1
"KAT2A",17,1,16,0,1
"HIST1H2AG",13,5,8,0,1
"HOXA5",12,2,10,0,1
"HS2ST1",6,3,3,0,1
"KLK2",8,2,6,0,1
"PTPRD",7,5,2,0,1
"INPP5E",4,2,2,0,1
"IQCK",2,1,1,0,1
"TBX18",4,3,1,0,1
"TBX5",6,3,3,0,1
"ITPR2",7,5,2,0,1
"KCNAB3",12,4,8,0,1
"SYNM",3,1,2,0,1
"MSX1",4,3,1,0,1
"LRPAP1",7,6,1,0,1
"MAP1B",12,4,8,0,1
"MARVELD2",6,4,2,0,1
"MEIOB",6,4,2,0,1
"SVOPL",2,1,1,0,1
"PIWIL2",10,5,5,0,1
"PIWIL4",9,3,6,0,1
"MRC2",3,1,2,0,1
"MRPS33",20,17,3,0,1
"TMOD1",19,3,16,0,1
"NDNL2",7,3,4,0,1
"NTF3",9,6,3,0,1
"NKD1",6,1,5,0,1
"RBFOX1",3,2,1,0,1
"RCN2",5,2,3,0,1
"VIP",8,4,4,0,1
"PIGP",3,2,1,0,1
"XKR4",2,1,1,0,1
"PLXNC1",6,1,5,0,1
"TEAD4",6,3,3,0,1
"RBKS",4,1,3,0,1
"USH2A",7,2,5,0,1
"ZCRB1",11,3,8,0,1
"SLC40A1",3,1,2,0,1
"SLC3A1",3,1,2,0,1
"ST6GALNAC5",2,1,1,0,1
"SULT1C2",3,1,2,0,1
"TCEAL8",2,1,1,0,1
"THOC3",2,1,1,0,1
"TRAF5",7,1,6,0,1
