"Name","K","Kin","Kout","TypeI","TypeII"
"MUC17",30,5,25,0,1
"MUC3A",27,14,13,0,1
"AQP4",15,10,5,0,1
"ABCE1",19,7,12,0,1
"ACTB",102,54,48,0,1
"BRIX1",30,17,13,0,1
"EIF6",15,11,4,0,1
"RPL28",16,13,3,0,1
"WDR43",29,24,5,0,1
"NPC1L1",6,3,3,0,1
"LYPLA1",10,4,6,0,1
"NRAS",85,50,35,0,1
"PARK2",23,13,10,0,1
"PRKAA2",13,10,3,0,1
"PSMB2",30,21,9,0,1
"PSMB8",51,33,18,0,1
"PSMB9",26,18,8,0,1
"PAICS",10,7,3,0,1
"PCCA",7,4,3,0,1
"ATP6AP2",10,8,2,0,1
"DPP4",18,10,8,0,1
"SLC15A1",7,4,3,0,1
"TNF",133,114,19,0,1
"GHRL",18,11,7,0,1
"MUSK",9,7,2,0,1
"NGF",29,19,10,0,1
"ACSL4",7,3,4,0,1
"ACTA1",33,18,15,0,1
"ACTR2",21,16,5,0,1
"ITGB1",118,95,23,0,1
"LAMB3",31,23,8,0,1
"ARPC1B",15,11,4,0,1
"CASP1",33,30,3,0,1
"CASP8",41,24,17,0,1
"DLG4",71,52,19,0,1
"DMD",43,22,21,0,1
"TRRAP",21,11,10,0,1
"MYL4",17,5,12,0,1
"RB1",41,14,27,0,1
"ANLN",80,17,63,0,1
"CD2AP",16,9,7,0,1
"RAC1",89,42,47,0,1
"ACTR3",14,1,13,0,1
"FCGR1A",28,16,12,0,1
"FCGR3A",55,34,21,0,1
"ADA",16,10,6,0,1
"EPHB2",31,21,10,0,1
"NOTCH1",40,16,24,0,1
"NOTCH3",21,7,14,0,1
"ADAMTS14",24,18,6,0,1
"COL11A2",6,2,4,0,1
"ADAMTSL5",12,4,8,0,1
"CAMK2A",30,18,12,0,1
"CAMK2B",26,18,8,0,1
"GNAI1",52,25,27,0,1
"GNAI2",67,21,46,0,1
"GNAI3",43,31,12,0,1
"PDE2A",11,5,6,0,1
"AVPR2",7,4,3,0,1
"ADCYAP1",13,12,1,0,1
"AOX1",16,10,6,0,1
"MAOA",18,7,11,0,1
"ADORA2B",7,3,4,0,1
"ADM2",2,1,1,0,1
"CXCR4",70,51,19,0,1
"F2",45,22,23,0,1
"PRRT2",11,9,2,0,1
"CAV3",35,17,18,0,1
"CCR3",37,30,7,0,1
"CHRM1",20,6,14,0,1
"GRIA1",33,26,7,0,1
"NPY",22,20,2,0,1
"MYOZ1",10,5,5,0,1
"AGO4",14,7,7,0,1
"CDS1",9,3,6,0,1
"GPD2",8,3,5,0,1
"TFF3",8,7,1,0,1
"HCK",40,38,2,0,1
"IDO1",16,14,2,0,1
"RSF1",13,7,6,0,1
"STAT1",52,7,45,0,1
"APOBEC4",4,2,2,0,1
"HIST2H3C",38,19,19,0,1
"UBE2D1",35,25,10,0,1
"WWC1",10,8,2,0,1
"TRPV4",7,5,2,0,1
"ALB",36,16,20,0,1
"CYCS",24,12,12,0,1
"CYP3A4",32,18,14,0,1
"GPT",10,8,2,0,1
"HP",27,16,11,0,1
"OCLN",27,15,12,0,1
"SERPINC1",31,23,8,0,1
"ALDH18A1",13,8,5,0,1
"UGT1A1",20,15,5,0,1
"FTCD",12,5,7,0,1
"PDE7B",7,1,6,0,1
"ALK",9,6,3,0,1
"JMJD7-PLA2G4B",6,4,2,0,1
"GGT7",17,11,6,0,1
"SERPINA5",15,7,8,0,1
"AMN",3,2,1,0,1
"AMPH",10,5,5,0,1
"SH3GL2",14,11,3,0,1
"GLUL",13,7,6,0,1
"FN1",91,56,35,0,1
"ANK2",24,13,11,0,1
"KCNQ3",22,17,5,0,1
"SCN2A",18,8,10,0,1
"SCN3B",16,12,4,0,1
"ASPM",137,88,49,0,1
"AURKB",149,69,80,0,1
"CDC20",147,104,43,0,1
"CDK1",223,177,46,0,1
"CENPA",118,55,63,0,1
"ECT2",73,58,15,0,1
"INCENP",60,47,13,0,1
"KIF20A",129,104,25,0,1
"KIF2C",129,92,37,0,1
"KPNA2",57,54,3,0,1
"MAD2L1",137,45,92,0,1
"NEK2",93,58,35,0,1
"PRC1",111,90,21,0,1
"RACGAP1",96,85,11,0,1
"RRM2",138,82,56,0,1
"SHCBP1",56,27,29,0,1
"TTK",136,91,45,0,1
"TYMS",100,53,47,0,1
"UBE2C",126,75,51,0,1
"ANO1",6,3,3,0,1
"SLC26A6",6,4,2,0,1
"CD5",29,14,15,0,1
"CD7",18,6,12,0,1
"ANXA2",17,10,7,0,1
"S100A10",9,8,1,0,1
"CD28",56,22,34,0,1
"AP1S1",6,3,3,0,1
"FABP1",15,5,10,0,1
"LIPC",16,9,7,0,1
"CDA",7,4,3,0,1
"APOC1",10,9,1,0,1
"BGN",29,16,13,0,1
"IDE",14,4,10,0,1
"TOMM40",7,5,2,0,1
"TREM2",14,7,7,0,1
"PLAUR",25,12,13,0,1
"AQP7",3,1,2,0,1
"PLIN1",8,3,5,0,1
"NCOA2",12,7,5,0,1
"KDELR1",7,4,3,0,1
"ARF6",33,13,20,0,1
"NME1",21,14,7,0,1
"ARHGDIB",10,2,8,0,1
"P2RX7",8,4,4,0,1
"ARL9",3,1,2,0,1
"CD3G",34,31,3,0,1
"POU3F3",4,3,1,0,1
"PCNA",109,82,27,0,1
"RRM1",73,29,44,0,1
"CAD",13,2,11,0,1
"CKS2",63,45,18,0,1
"KIF20B",46,29,17,0,1
"RBBP8",43,35,8,0,1
"STIL",36,24,12,0,1
"ASPN",8,5,3,0,1
"SMC4",83,49,34,0,1
"BLM",69,35,34,0,1
"SMC3",55,37,18,0,1
"JUN",39,18,21,0,1
"TMEM30B",4,3,1,0,1
"ATP1A2",7,3,4,0,1
"PRKG2",23,6,17,0,1
"ATP6V0D2",11,1,10,0,1
"ATP6V1G2",9,3,6,0,1
"CDC25A",54,26,28,0,1
"TROAP",53,7,46,0,1
"UBE2N",42,15,27,0,1
"CASC5",56,30,26,0,1
"STMN1",13,12,1,0,1
"VCAN",26,5,21,0,1
"MUC21",17,6,11,0,1
"FADD",30,11,19,0,1
"BANF1",10,3,7,0,1
"CBX3",20,4,16,0,1
"BCAN",14,6,8,0,1
"SYK",61,44,17,0,1
"EOMES",7,5,2,0,1
"REL",16,3,13,0,1
"INPP5D",22,18,4,0,1
"BEGAIN",4,3,1,0,1
"FANCM",37,8,29,0,1
"DYNC1I1",8,4,4,0,1
"KIF5B",14,5,9,0,1
"FASLG",20,15,5,0,1
"MAPK10",28,14,14,0,1
"LCK",64,26,38,0,1
"BMPR2",19,12,7,0,1
"GREM2",5,3,2,0,1
"NOG",13,8,5,0,1
"DKC1",33,25,8,0,1
"ESCO2",63,28,35,0,1
"CASK",14,8,6,0,1
"C1GALT1C1",20,4,16,0,1
"CACNA1B",24,14,10,0,1
"CACNA1F",19,12,7,0,1
"HSPA2",15,11,4,0,1
"ITGB2",56,45,11,0,1
"C1QB",23,13,10,0,1
"CTSS",24,10,14,0,1
"DXO",2,1,1,0,1
"CFHR1",7,3,4,0,1
"CFHR3",5,4,1,0,1
"C4BPA",3,1,2,0,1
"C6",4,2,2,0,1
"CACNA1D",30,10,20,0,1
"CACNA1S",22,9,13,0,1
"CALCRL",6,5,1,0,1
"VIP",18,11,7,0,1
"MMP9",56,36,20,0,1
"CARKD",6,3,3,0,1
"LEP",19,7,12,0,1
"NLGN1",10,7,3,0,1
"PTBP1",18,10,8,0,1
"MAPK11",40,16,24,0,1
"SUV39H1",11,8,3,0,1
"DNAH1",6,5,1,0,1
"RBM44",4,2,2,0,1
"PSMD1",24,11,13,0,1
"CCR5",55,11,44,0,1
"CX3CR1",27,10,17,0,1
"CXCR3",37,23,14,0,1
"CCL20",31,20,11,0,1
"CXCL8",68,31,37,0,1
"IL18",29,10,19,0,1
"IL1B",77,19,58,0,1
"TERT",24,13,11,0,1
"LIN9",16,11,5,0,1
"PTP4A1",5,4,1,0,1
"KPNA7",7,4,3,0,1
"PRKAR2A",26,7,19,0,1
"PRKAR2B",26,6,20,0,1
"RCC1",12,7,5,0,1
"CD86",57,27,30,0,1
"CD80",59,11,48,0,1
"MOB4",7,4,3,0,1
"TUBA1B",22,11,11,0,1
"CD14",25,8,17,0,1
"IRAK1",28,16,12,0,1
"CD3D",36,12,24,0,1
"HLA-DRB1",42,18,24,0,1
"IL17A",42,24,18,0,1
"ITGA10",15,8,7,0,1
"ITGA8",24,13,11,0,1
"ESPN",8,5,3,0,1
"KIT",38,12,26,0,1
"RGS1",19,12,7,0,1
"GZMA",14,7,7,0,1
"IL33",6,5,1,0,1
"SLA2",8,2,6,0,1
"TLR3",20,7,13,0,1
"TLR8",12,6,6,0,1
"MAP3K1",29,20,9,0,1
"VANGL1",6,4,2,0,1
"SH2D1B",2,1,1,0,1
"CDC73",5,3,2,0,1
"CLDN7",13,7,6,0,1
"CSE1L",9,5,4,0,1
"F11R",16,7,9,0,1
"MMP3",27,10,17,0,1
"PKP3",18,8,10,0,1
"COL3A1",26,13,13,0,1
"LRP5",21,11,10,0,1
"MYO3A",4,1,3,0,1
"LEF1",34,3,31,0,1
"CEACAM19",3,1,2,0,1
"CEACAM5",7,2,5,0,1
"KLK3",7,2,5,0,1
"EFNA2",12,2,10,0,1
"MEST",4,1,3,0,1
"UGT8",10,4,6,0,1
"CFAP69",4,1,3,0,1
"PRSS1",12,6,6,0,1
"MARVELD2",11,5,6,0,1
"CLDN12",10,2,8,0,1
"CHAC2",5,2,3,0,1
"CHL1",11,1,10,0,1
"RGMB",11,2,9,0,1
"LAMA3",31,16,15,0,1
"USH2A",6,3,3,0,1
"CIDEA",7,3,4,0,1
"SI",6,2,4,0,1
"CLN6",5,2,3,0,1
"MMP1",26,15,11,0,1
"DCK",20,7,13,0,1
"DTYMK",17,10,7,0,1
"LOR",10,6,4,0,1
"CNGB3",5,2,3,0,1
"RD3",5,3,2,0,1
"CNR2",4,3,1,0,1
"CRLF1",3,2,1,0,1
"LUM",25,6,19,0,1
"CPLX2",9,4,5,0,1
"SNRPB",32,26,6,0,1
"KYNU",5,1,4,0,1
"MAGEA3",6,4,2,0,1
"IL23R",10,7,3,0,1
"MED1",20,7,13,0,1
"GBP1",20,10,10,0,1
"TXN",18,10,8,0,1
"KL",8,5,3,0,1
"PTGS1",9,4,5,0,1
"CYP2C9",27,5,22,0,1
"SLC51B",2,1,1,0,1
"DDC",8,5,3,0,1
"PIFO",2,1,1,0,1
"ULK1",8,3,5,0,1
"PCDH15",6,4,2,0,1
"FZD2",24,13,11,0,1
"DLEC1",4,1,3,0,1
"DLGAP2",7,6,1,0,1
"DMBT1",7,4,3,0,1
"HAP1",7,2,5,0,1
"EVPL",9,3,6,0,1
"PTPRR",4,2,2,0,1
"EZH2",45,9,36,0,1
"SP1",25,6,19,0,1
"EDARADD",2,1,1,0,1
"EFNA4",10,8,2,0,1
"GRB7",9,7,2,0,1
"TTC7B",3,1,2,0,1
"EPS8",9,3,6,0,1
"LEPR",13,8,5,0,1
"PPP2R5E",14,7,7,0,1
"SOX10",13,7,6,0,1
"IFIH1",43,9,34,0,1
"ELP4",4,3,1,0,1
"G6PD",13,8,5,0,1
"PKLR",11,5,6,0,1
"SPINT2",9,3,6,0,1
"SMC1B",22,11,11,0,1
"PNO1",27,6,21,0,1
"EXPH5",2,1,1,0,1
"F10",11,8,3,0,1
"PLAU",17,10,7,0,1
"SORD",5,2,3,0,1
"TNFRSF6B",2,1,1,0,1
"NCR3",12,6,6,0,1
"PIGR",3,1,2,0,1
"FGF10",6,1,5,0,1
"LCN2",13,11,2,0,1
"RGS7",9,6,3,0,1
"HNF4A",18,7,11,0,1
"GMDS",3,2,1,0,1
"FPR2",4,2,2,0,1
"GPSM2",5,4,1,0,1
"HKDC1",16,9,7,0,1
"GABBR1",11,9,2,0,1
"GATA2",10,6,4,0,1
"RGS18",9,7,2,0,1
"RGS19",9,7,2,0,1
"TAS1R1",6,3,3,0,1
"GPD1",7,1,6,0,1
"GNRH1",6,3,3,0,1
"NEGR1",4,3,1,0,1
"RAB25",4,3,1,0,1
"IRF6",17,3,14,0,1
"KIF5A",13,8,5,0,1
"HOXA9",4,2,2,0,1
"MEIS1",8,2,6,0,1
"HOXC6",3,1,2,0,1
"IGF2BP1",5,1,4,0,1
"METTL3",5,2,3,0,1
"IL17RB",4,1,3,0,1
"IL17RD",6,2,4,0,1
"IL1RAP",8,6,2,0,1
"KCND2",17,7,10,0,1
"KCNK12",4,1,3,0,1
"REEP1",3,2,1,0,1
"KLK2",8,2,6,0,1
"LRRC61",2,1,1,0,1
"LACTB2",4,2,2,0,1
"PNISR",10,4,6,0,1
"LGR5",6,2,4,0,1
"LIMK1",8,2,6,0,1
"PPP1R14C",2,1,1,0,1
"PHLDA2",2,1,1,0,1
"RAB10",8,2,6,0,1
"RAB8A",19,9,10,0,1
"RPL22L1",10,4,6,0,1
"SH2B1",8,1,7,0,1
"POTEF",3,1,2,0,1
"NAA15",3,1,2,0,1
"ST8SIA5",3,1,2,0,1
"TMEM144",2,1,1,0,1
"NUDT1",3,2,1,0,1
"ZP3",2,1,1,0,1
"P2RY13",3,2,1,0,1
"PABPC1",15,2,13,0,1
"PLAGL1",4,1,3,0,1
"PGM2L1",2,1,1,0,1
"PHF14",2,1,1,0,1
"SLC8A1",7,5,2,0,1
"PLXNB3",4,3,1,0,1
"REST",10,2,8,0,1
"SCNN1G",8,2,6,0,1
"U2AF1L4",10,4,6,0,1
"SOWAHB",2,1,1,0,1
"SLC30A6",6,4,2,0,1
"SLC35C1",4,1,3,0,1
"SLC5A1",6,1,5,0,1
"SULF1",3,1,2,0,1
"SPOCK3",3,2,1,0,1
"SPINK5",4,2,2,0,1
"ST3GAL3",15,1,14,0,1
"TCAP",9,1,8,0,1
"TCEAL1",3,1,2,0,1
