"Name","K","Kin","Kout","TypeI","TypeII"
"GRB2",129,94,35,0,1
"A2M",15,7,8,0,1
"HP",23,16,7,0,1
"HSPA5",48,24,24,0,1
"EVPL",15,7,8,0,1
"PPL",19,12,7,0,1
"AACS",3,1,2,0,1
"CNDP2",11,5,6,0,1
"MARS2",10,2,8,0,1
"ABAT",12,9,3,0,1
"ALOX12B",15,7,8,0,1
"TMPRSS6",9,6,3,0,1
"ABCA4",5,4,1,0,1
"SLCO1A2",6,4,2,0,1
"PDZK1",6,5,1,0,1
"KCNJ11",5,4,1,0,1
"ALDH3A2",17,10,7,0,1
"ALDH1A1",15,6,9,0,1
"EGFR",135,36,99,0,1
"SLC47A1",4,2,2,0,1
"ATP1A3",3,2,1,0,1
"SCARB1",8,3,5,0,1
"PSMB4",16,5,11,0,1
"ACAN",38,32,6,0,1
"NGF",31,16,15,0,1
"NTRK1",35,28,7,0,1
"CXCL11",28,9,19,0,1
"GLUD2",15,8,7,0,1
"HMGCS1",8,3,5,0,1
"PKM",38,12,26,0,1
"AGXT",9,3,6,0,1
"CYCS",33,13,20,0,1
"GPI",19,15,4,0,1
"HSPD1",35,27,8,0,1
"NME2",11,10,1,0,1
"ACP2",3,1,2,0,1
"LPL",25,14,11,0,1
"AGRN",25,18,7,0,1
"MYLPF",18,8,10,0,1
"HCLS1",19,9,10,0,1
"WAS",32,16,16,0,1
"ACVR2B",13,8,5,0,1
"TGFBR1",20,12,8,0,1
"CDH2",14,5,9,0,1
"CTNNB1",104,57,47,0,1
"DLL1",10,7,3,0,1
"UBB",62,21,41,0,1
"PIK3R1",119,101,18,0,1
"SRC",125,80,45,0,1
"BCAN",11,7,4,0,1
"HLA-C",60,39,21,0,1
"METTL13",4,3,1,0,1
"GNAI2",72,23,49,0,1
"PRKCD",46,35,11,0,1
"PRKCE",24,9,15,0,1
"GNAS",31,16,15,0,1
"PRKACB",63,39,24,0,1
"GNG10",15,12,3,0,1
"CNR1",17,10,7,0,1
"ENTPD2",9,5,4,0,1
"ADH1B",12,6,6,0,1
"AOX1",21,14,7,0,1
"CYP2E1",26,24,2,0,1
"ADM2",6,4,2,0,1
"POMC",17,13,4,0,1
"GNA13",30,24,6,0,1
"BSG",13,7,6,0,1
"GNAI1",38,9,29,0,1
"TFPI",9,2,7,0,1
"LCK",95,37,58,0,1
"AGER",8,4,4,0,1
"ITGB2",76,62,14,0,1
"JAK2",85,58,27,0,1
"LTB4R",2,1,1,0,1
"AGPAT1",8,5,3,0,1
"AGPAT4",9,5,4,0,1
"AGPAT5",10,1,9,0,1
"MBOAT1",14,6,8,0,1
"CSPG5",13,10,3,0,1
"SDC1",36,29,7,0,1
"AHCYL2",6,3,3,0,1
"LDHB",18,11,7,0,1
"DYSF",5,4,1,0,1
"PTPRC",124,107,17,0,1
"H2AFX",53,45,8,0,1
"AIM2",11,4,7,0,1
"CASP5",9,6,3,0,1
"NLRC4",13,9,4,0,1
"HSP90AB1",47,30,17,0,1
"NT5M",14,12,2,0,1
"RRM2",125,72,53,0,1
"AK8",3,1,2,0,1
"NME1",15,8,7,0,1
"PKLR",20,7,13,0,1
"ALDH1B1",9,7,2,0,1
"GLB1",25,12,13,0,1
"HK3",14,6,8,0,1
"AKR1C3",15,9,6,0,1
"AKT3",23,3,20,0,1
"CASP9",13,11,2,0,1
"HSP90AA1",98,44,54,0,1
"TSC1",19,7,12,0,1
"ALB",20,8,12,0,1
"CYP3A4",23,12,11,0,1
"OCLN",21,12,9,0,1
"PLG",29,13,16,0,1
"SERPINC1",20,15,5,0,1
"GLUL",21,8,13,0,1
"MAOA",17,6,11,0,1
"GAPDH",44,5,39,0,1
"PFKM",21,10,11,0,1
"ALG1",3,1,2,0,1
"ALG8",5,2,3,0,1
"ALK",13,7,6,0,1
"AMBP",9,3,6,0,1
"CYP17A1",14,6,8,0,1
"LILRB2",29,20,9,0,1
"PARD3",9,5,4,0,1
"GCSH",7,5,2,0,1
"TIE1",5,2,3,0,1
"SCN2A",14,8,6,0,1
"SCN3B",14,12,2,0,1
"SCN5A",25,22,3,0,1
"ANKK1",3,2,1,0,1
"TCAP",20,7,13,0,1
"AURKB",134,63,71,0,1
"CCNA2",147,45,102,0,1
"CDC20",140,101,39,0,1
"CDC25C",74,35,39,0,1
"CDCA8",122,90,32,0,1
"CDK1",183,149,34,0,1
"CENPA",110,55,55,0,1
"KIF14",70,45,25,0,1
"KIF20A",117,96,21,0,1
"KIF2C",123,91,32,0,1
"NEK2",86,54,32,0,1
"SHCBP1",55,27,28,0,1
"TTK",121,82,39,0,1
"TYMS",96,50,46,0,1
"UBE2C",116,68,48,0,1
"ANPEP",20,6,14,0,1
"CD5",31,16,15,0,1
"CD7",17,8,9,0,1
"DPP4",19,10,9,0,1
"FCGR1A",38,20,18,0,1
"GGT5",13,9,4,0,1
"NEDD4",18,14,4,0,1
"ANXA5",11,5,6,0,1
"HSPA8",67,60,7,0,1
"CLTB",18,6,12,0,1
"DLG2",21,9,12,0,1
"NRXN1",18,12,6,0,1
"APITD1",28,9,19,0,1
"BLM",60,28,32,0,1
"CASC5",53,27,26,0,1
"GPC3",18,17,1,0,1
"RBP4",6,4,2,0,1
"SNCA",35,19,16,0,1
"MAPT",23,14,9,0,1
"TREM2",22,10,12,0,1
"PLAUR",32,17,15,0,1
"APOO",9,4,5,0,1
"AQP3",3,2,1,0,1
"PLIN1",11,4,7,0,1
"GRIA1",22,18,4,0,1
"GRIN1",18,13,5,0,1
"ASS1",8,3,5,0,1
"PTPN13",12,10,2,0,1
"COPA",11,6,5,0,1
"ARHGDIB",11,2,9,0,1
"ARHGEF11",9,5,4,0,1
"DAAM1",10,7,3,0,1
"ARHGEF2",12,10,2,0,1
"ARL6IP5",3,1,2,0,1
"DYX1C1",10,3,7,0,1
"ARPC1A",7,1,6,0,1
"MYO5A",13,9,4,0,1
"CD3G",45,41,4,0,1
"SUMF2",4,3,1,0,1
"ID1",6,4,2,0,1
"TCF4",10,9,1,0,1
"H2AFV",41,12,29,0,1
"IPO4",17,8,9,0,1
"PCNA",97,73,24,0,1
"PSAT1",5,4,1,0,1
"CHEK1",118,103,15,0,1
"CKS2",62,45,17,0,1
"CBX8",15,4,11,0,1
"BTAF1",2,1,1,0,1
"JUN",47,21,26,0,1
"ULK1",10,4,6,0,1
"PFAS",6,4,2,0,1
"NSUN7",2,1,1,0,1
"TMEM30B",4,3,1,0,1
"PLN",11,4,7,0,1
"ATP1A2",7,4,3,0,1
"PRKG1",13,10,3,0,1
"ATP2A1",5,2,3,0,1
"GINS2",87,13,74,0,1
"MAPRE1",19,13,6,0,1
"NCAPD2",54,32,22,0,1
"NDEL1",12,5,7,0,1
"TDRD7",5,2,3,0,1
"AXIN2",9,6,3,0,1
"FUT2",8,7,1,0,1
"UGT2B7",6,3,3,0,1
"FMOD",16,9,7,0,1
"GCNT2",4,2,2,0,1
"B3GNT3",13,4,9,0,1
"MUC16",15,9,6,0,1
"MUC7",10,6,4,0,1
"B4GALNT1",11,4,7,0,1
"KIF5A",13,9,4,0,1
"ST3GAL2",13,8,5,0,1
"ST3GAL5",10,7,3,0,1
"B4GALT6",12,3,9,0,1
"GBA",15,6,9,0,1
"PIGP",7,6,1,0,1
"BCL6",25,14,11,0,1
"SOX2",18,3,15,0,1
"HIST1H2BK",27,15,12,0,1
"EOMES",6,4,2,0,1
"GATA3",21,10,11,0,1
"INPP5D",31,25,6,0,1
"PTPN6",78,63,15,0,1
"HIST1H2AD",30,10,20,0,1
"HIST1H3H",27,14,13,0,1
"TLE4",8,7,1,0,1
"BEX1",4,3,1,0,1
"BFSP1",4,3,1,0,1
"BFSP2",3,2,1,0,1
"CHDH",5,1,4,0,1
"BIN3",2,1,1,0,1
"SNAPC5",4,1,3,0,1
"CD79B",31,18,13,0,1
"PTK2B",39,31,8,0,1
"S1PR1",19,8,11,0,1
"SYK",95,58,37,0,1
"ZAP70",57,14,43,0,1
"SMAD1",7,4,3,0,1
"TNFSF11",14,10,4,0,1
"BOP1",15,14,1,0,1
"CLSPN",44,22,22,0,1
"RAD51C",41,16,25,0,1
"SPN",25,16,9,0,1
"BST2",28,4,24,0,1
"CD247",68,34,34,0,1
"BYSL",20,2,18,0,1
"GNL3L",11,3,8,0,1
"PES1",15,7,8,0,1
"WDR46",17,9,8,0,1
"MS4A6A",14,13,1,0,1
"C1QB",27,12,15,0,1
"CALR",36,14,22,0,1
"CFH",16,7,9,0,1
"CTSS",28,14,14,0,1
"MPEG1",8,5,3,0,1
"RUVBL1",46,14,32,0,1
"THBD",16,15,1,0,1
"FAM69C",2,1,1,0,1
"C9orf173",2,1,1,0,1
"CYP24A1",9,1,8,0,1
"CDK2",66,21,45,0,1
"CACNA1G",11,6,5,0,1
"CACNA1H",13,7,6,0,1
"CACNB2",20,7,13,0,1
"CALM3",24,8,16,0,1
"GNG2",43,16,27,0,1
"STXBP1",22,11,11,0,1
"CATSPER2",10,5,5,0,1
"MYH10",9,5,4,0,1
"PHKA1",4,3,1,0,1
"PDIA6",15,12,3,0,1
"KSR1",9,7,2,0,1
"SND1",4,2,2,0,1
"FPR2",8,6,2,0,1
"PDIA4",12,4,8,0,1
"SLC6A4",10,3,7,0,1
"PHLPP1",2,1,1,0,1
"CARD11",17,12,5,0,1
"CBX3",13,4,9,0,1
"CFAP69",6,3,3,0,1
"RBM44",5,2,3,0,1
"CX3CR1",32,13,19,0,1
"CXCR3",40,22,18,0,1
"CCR5",61,15,46,0,1
"RBL1",19,15,4,0,1
"CDK4",51,6,45,0,1
"RB1",29,10,19,0,1
"YWHAG",19,7,12,0,1
"CD86",71,35,36,0,1
"FCGR3A",68,37,31,0,1
"CD28",65,26,39,0,1
"CTLA4",69,25,44,0,1
"TUBA1B",18,12,6,0,1
"CD14",21,8,13,0,1
"CD3D",43,13,30,0,1
"ITGAL",27,15,12,0,1
"RGS1",17,9,8,0,1
"HLA-DRB1",55,26,29,0,1
"MAP1LC3A",8,6,2,0,1
"SQSTM1",26,20,6,0,1
"TREML1",6,4,2,0,1
"CLEC12A",4,2,2,0,1
"IL3RA",25,9,16,0,1
"NMNAT3",4,2,2,0,1
"PRKCB",32,13,19,0,1
"CD70",7,2,5,0,1
"CD80",65,8,57,0,1
"CSF1R",57,13,44,0,1
"FASLG",19,9,10,0,1
"FCGR2B",39,18,21,0,1
"GZMA",18,9,9,0,1
"HLA-DQA1",33,11,22,0,1
"IL1B",91,17,74,0,1
"TNFRSF10A",15,2,13,0,1
"TNFRSF8",11,3,8,0,1
"CD6",6,3,3,0,1
"ITGA5",41,14,27,0,1
"SH2D1B",7,3,4,0,1
"MSN",17,11,6,0,1
"GINS4",27,14,13,0,1
"MYO7A",4,3,1,0,1
"CDH5",23,7,16,0,1
"CDS1",7,1,6,0,1
"E2F1",27,4,23,0,1
"KLF4",11,8,3,0,1
"MAP3K11",9,3,6,0,1
"CEL",6,5,1,0,1
"VANGL2",8,5,3,0,1
"CENPH",29,7,22,0,1
"TTLL1",3,1,2,0,1
"CFAP221",9,7,2,0,1
"CFAP45",2,1,1,0,1
"TRPC6",11,3,8,0,1
"MARVELD2",6,3,3,0,1
"TXNDC12",3,2,1,0,1
"PLD3",8,6,2,0,1
"CHL1",10,1,9,0,1
"GFRA1",9,4,5,0,1
"CSPG4",15,8,7,0,1
"GIT2",12,5,7,0,1
"LAMA3",29,15,14,0,1
"CIDEA",7,3,4,0,1
"CKLF",3,1,2,0,1
"CLDN3",7,4,3,0,1
"CLDN7",10,5,5,0,1
"CLEC4D",3,2,1,0,1
"CLEC7A",12,3,9,0,1
"TPP1",6,3,3,0,1
"CMA1",6,2,4,0,1
"ENTPD3",12,3,9,0,1
"HTR3A",9,6,3,0,1
"LGI1",4,2,2,0,1
"COPS6",8,2,6,0,1
"HM13",10,7,3,0,1
"HEPH",4,3,1,0,1
"FCER1A",16,7,9,0,1
"CRB3",4,2,2,0,1
"MBTPS2",2,1,1,0,1
"SPRR3",10,5,5,0,1
"IL1A",22,5,17,0,1
"EREG",13,2,11,0,1
"SDC3",21,13,8,0,1
"CTAG1B",8,2,6,0,1
"PARK2",19,12,7,0,1
"LPAR1",18,11,7,0,1
"CYP11A1",7,1,6,0,1
"CYP27C1",4,2,2,0,1
"CYP3A5",18,2,16,0,1
"GSTA4",10,5,5,0,1
"GNA12",29,4,25,0,1
"MGLL",12,1,11,0,1
"DFNB59",4,3,1,0,1
"PNPLA2",10,4,6,0,1
"PTCH2",5,4,1,0,1
"WNT7B",19,13,6,0,1
"NLGN4X",8,4,4,0,1
"GRM1",9,6,3,0,1
"LHX6",3,2,1,0,1
"DMBT1",3,1,2,0,1
"RSPH9",8,4,4,0,1
"HSPA13",8,1,7,0,1
"ZEB1",14,10,4,0,1
"SMARCD1",7,3,4,0,1
"MUSK",7,5,2,0,1
"SPINK5",7,3,4,0,1
"DTNBP1",5,2,3,0,1
"TCTE3",4,2,2,0,1
"NPDC1",4,3,1,0,1
"EAF2",2,1,1,0,1
"EDN3",3,2,1,0,1
"PRKAG2",12,5,7,0,1
"IRS1",25,5,20,0,1
"LEP",15,8,7,0,1
"PTRF",6,3,3,0,1
"F3",16,11,5,0,1
"STAT1",61,10,51,0,1
"IFIH1",33,8,25,0,1
"TRPC1",11,9,2,0,1
"FGFR3",11,5,6,0,1
"PLXNB1",11,8,3,0,1
"ESPN",3,2,1,0,1
"ESYT3",2,1,1,0,1
"MED13L",5,2,3,0,1
"HCN2",3,1,2,0,1
"FLNC",10,2,8,0,1
"RGS7",10,4,6,0,1
"SOX10",12,6,6,0,1
"WNT3A",19,8,11,0,1
"IL6R",20,10,10,0,1
"RUNX3",10,6,4,0,1
"NHS",2,1,1,0,1
"SH3TC2",5,3,2,0,1
"ST8SIA1",6,5,1,0,1
"WIF1",15,9,6,0,1
"PAEP",3,2,1,0,1
"PLCB2",25,3,22,0,1
"TAS1R1",7,3,4,0,1
"PIGM",8,5,3,0,1
"PNPLA7",9,7,2,0,1
"TYRP1",11,6,5,0,1
"RAB25",3,2,1,0,1
"GSTM1",5,1,4,0,1
"HDC",7,1,6,0,1
"HERC6",18,5,13,0,1
"HEY2",2,1,1,0,1
"HOXA9",4,2,2,0,1
"HOXA5",7,2,5,0,1
"MEIS1",13,4,9,0,1
"NLRP3",18,4,14,0,1
"MRPL12",15,9,6,0,1
"HTR1D",3,2,1,0,1
"SOAT2",4,2,2,0,1
"IL20RA",3,1,2,0,1
"IL36RN",4,3,1,0,1
"KBTBD7",3,2,1,0,1
"TRPM4",13,1,12,0,1
"KCNJ10",4,3,1,0,1
"KCNN4",3,2,1,0,1
"KCTD17",4,2,2,0,1
"POU5F1",23,3,20,0,1
"THRB",8,3,5,0,1
"KLHL3",7,1,6,0,1
"LGR5",6,2,4,0,1
"RSPO3",4,2,2,0,1
"LIMK1",11,5,6,0,1
"LRPAP1",10,7,3,0,1
"MYCBP2",4,3,1,0,1
"NXN",2,1,1,0,1
"PHLDB3",2,1,1,0,1
"RAB27A",9,6,3,0,1
"OPN3",2,1,1,0,1
"NEFH",5,3,2,0,1
"MASP1",2,1,1,0,1
"TSPEAR",2,1,1,0,1
"PCK1",3,2,1,0,1
"PKD1",5,1,4,0,1
"NKX2-5",6,1,5,0,1
"MRPS23",9,5,4,0,1
"TOMM40L",6,5,1,0,1
"MRPL17",13,4,9,0,1
"MT1X",4,3,1,0,1
"SIGLEC9",3,1,2,0,1
"NPL",5,1,4,0,1
"REL",10,2,8,0,1
"NTRK3",12,4,8,0,1
"PIK3R3",38,4,34,0,1
"ONECUT1",3,1,2,0,1
"NRROS",3,1,2,0,1
"OLIG2",9,2,7,0,1
"PHLDA2",2,1,1,0,1
"SPTSSB",2,1,1,0,1
"VGF",2,1,1,0,1
"PNPO",4,1,3,0,1
"PLAGL1",4,1,3,0,1
"PIP5KL1",5,2,3,0,1
"POMGNT1",5,2,3,0,1
"PPP2R2C",2,1,1,0,1
"SERTAD4",2,1,1,0,1
"PTGES",5,1,4,0,1
"PYGB",7,1,6,0,1
"RHPN1",5,3,2,0,1
"RPE65",4,1,3,0,1
"S100A3",3,2,1,0,1
"SCG2",5,3,2,0,1
"SPECC1",3,1,2,0,1
"SLC15A1",3,1,2,0,1
"SLC3A1",3,1,2,0,1
"SNX22",2,1,1,0,1
"SPAG17",3,1,2,0,1
"SPRR2E",6,2,4,0,1
"STXBP5",5,2,3,0,1
