"Name","K","Kin","Kout","TypeI","TypeII"
"IL6R",17,11,6,0,1
"SHOC2",6,3,3,0,1
"GATM",17,16,1,0,1
"ABCC2",2,1,1,0,1
"RDX",6,5,1,0,1
"SLC51A",4,3,1,0,1
"SLCO2B1",5,2,3,0,1
"PDZK1",5,4,1,0,1
"AQP4",5,4,1,0,1
"INS",45,37,8,0,1
"PRKACB",56,41,15,0,1
"PEX11A",6,3,3,0,1
"ABHD12",4,2,2,0,1
"ABI2",6,2,4,0,1
"RAC3",28,15,13,0,1
"DBT",21,13,8,0,1
"DLST",9,3,6,0,1
"ECI2",15,11,4,0,1
"SUCLG2",18,15,3,0,1
"CPT1A",15,4,11,0,1
"AOX1",22,14,8,0,1
"ATP6AP2",15,14,1,0,1
"KLK4",4,1,3,0,1
"AGTR1",7,6,1,0,1
"CXCR4",49,40,9,0,1
"EGFR",110,23,87,0,1
"CCL21",12,3,9,0,1
"GLUD2",15,7,8,0,1
"IDH2",10,5,5,0,1
"ACOT4",15,8,7,0,1
"THEM5",2,1,1,0,1
"FADS2",10,2,8,0,1
"CPT1C",3,2,1,0,1
"MYH7",6,1,5,0,1
"H2AFZ",33,10,23,0,1
"SRCAP",6,2,4,0,1
"ACTR1A",14,10,4,0,1
"DYNLL1",15,13,2,0,1
"LRRC61",3,2,1,0,1
"ACVR1",11,3,8,0,1
"ADA",8,7,1,0,1
"ITGB1",97,78,19,0,1
"ADAMTS10",18,3,15,0,1
"ADAMTS15",20,11,9,0,1
"ADAMTS3",21,7,14,0,1
"ADAMTSL3",22,9,13,0,1
"SBSPON",10,4,6,0,1
"THSD7A",14,11,3,0,1
"COL27A1",6,4,2,0,1
"SDC4",26,19,7,0,1
"ADCY1",25,2,23,0,1
"ADCY2",24,11,13,0,1
"CAMK2A",17,14,3,0,1
"CNR1",9,6,3,0,1
"GNAS",35,25,10,0,1
"GNG2",38,18,20,0,1
"PDE3A",9,7,2,0,1
"PDE4B",8,4,4,0,1
"PDE4D",9,5,4,0,1
"PDE8A",9,3,6,0,1
"PRKAR1B",13,11,2,0,1
"ADCY10",4,1,3,0,1
"AKTIP",2,1,1,0,1
"ADCY7",24,19,5,0,1
"ADCY4",10,4,6,0,1
"ADH1B",19,6,13,0,1
"GSTA1",14,4,10,0,1
"MAOA",16,8,8,0,1
"SNTB1",4,3,1,0,1
"AP1S1",12,3,9,0,1
"AGPAT4",11,5,6,0,1
"LEP",21,13,8,0,1
"POMC",27,20,7,0,1
"TRH",10,4,6,0,1
"AR",10,3,7,0,1
"CAV1",36,18,18,0,1
"CYCS",35,9,26,0,1
"CTNNA1",29,16,13,0,1
"JUP",20,14,6,0,1
"LATS2",9,5,4,0,1
"AKAP4",3,1,2,0,1
"AKAP5",17,11,6,0,1
"DLG4",82,60,22,0,1
"AKAP6",6,1,5,0,1
"AKR1B1",13,4,9,0,1
"FABP5",4,1,3,0,1
"TH",22,14,8,0,1
"TXNRD2",12,7,5,0,1
"BCL2",16,11,5,0,1
"FYN",69,39,30,0,1
"MAPK11",34,14,20,0,1
"OGT",8,6,2,0,1
"ALAS1",4,2,2,0,1
"L1CAM",13,6,7,0,1
"ALDH1A1",11,3,8,0,1
"CYP3A4",27,10,17,0,1
"SHMT1",8,2,6,0,1
"AOC3",17,3,14,0,1
"GLUL",16,5,11,0,1
"PGM2",14,9,5,0,1
"ALDOC",4,1,3,0,1
"ALK",11,6,5,0,1
"ALOX5",13,7,6,0,1
"GDI1",15,12,3,0,1
"PLG",19,6,13,0,1
"CYP19A1",18,14,4,0,1
"AMPH",17,7,10,0,1
"CNTNAP2",13,4,9,0,1
"DNM1",28,16,12,0,1
"SNAP91",11,9,2,0,1
"MET",29,13,16,0,1
"FN1",80,47,33,0,1
"ANK2",22,14,8,0,1
"KCNQ2",36,20,16,0,1
"SCN2A",26,18,8,0,1
"FKRP",6,1,5,0,1
"CD5",13,6,7,0,1
"DPP4",18,9,9,0,1
"ITGAM",66,59,7,0,1
"ANXA2",14,7,7,0,1
"DYSF",6,5,1,0,1
"FCGR2B",21,11,10,0,1
"AP2A1",17,11,6,0,1
"AP3M2",5,3,2,0,1
"NCALD",6,4,2,0,1
"APP",62,17,45,0,1
"DLG3",32,18,14,0,1
"GRIN1",27,18,9,0,1
"NRXN2",24,4,20,0,1
"PPFIA3",22,13,9,0,1
"SLC18A2",18,7,11,0,1
"STXBP1",36,18,18,0,1
"APOE",28,1,27,0,1
"CFH",16,7,9,0,1
"HP",18,10,8,0,1
"MAP2",18,12,6,0,1
"MAPT",37,20,17,0,1
"SDC2",26,9,17,0,1
"CASP8",27,12,15,0,1
"HSPA5",38,18,20,0,1
"LRRK2",25,11,14,0,1
"PCYOX1",4,3,1,0,1
"SNCA",31,15,16,0,1
"AQP10",4,2,2,0,1
"AQP11",3,2,1,0,1
"MNDA",10,6,4,0,1
"ARF3",4,1,3,0,1
"HRAS",57,49,8,0,1
"ASS1",2,1,1,0,1
"IL10",58,51,7,0,1
"YWHAZ",38,30,8,0,1
"PAK1",32,7,25,0,1
"ARHGEF9",7,1,6,0,1
"CFAP36",2,1,1,0,1
"ARL6",3,2,1,0,1
"PPARA",15,6,9,0,1
"NR1D2",5,3,2,0,1
"NECAP1",13,4,9,0,1
"EZR",28,15,13,0,1
"ASCL1",9,1,8,0,1
"REST",5,2,3,0,1
"ASPDH",5,2,3,0,1
"NAT8L",5,3,2,0,1
"ASPA",4,1,3,0,1
"GLS",8,3,5,0,1
"ASPHD1",6,3,3,0,1
"CDK1",68,54,14,0,1
"ATL1",6,3,3,0,1
"SNRPN",14,11,3,0,1
"TNNC2",6,2,4,0,1
"RYR2",12,7,5,0,1
"NDUFS6",19,5,14,0,1
"UQCRB",21,19,2,0,1
"CACNG2",32,11,21,0,1
"ATP7A",3,2,1,0,1
"ATR",12,6,6,0,1
"TP53BP1",11,5,6,0,1
"FUT2",14,11,3,0,1
"GPC4",19,13,6,0,1
"B4GALT1",19,12,7,0,1
"MUC15",8,4,4,0,1
"OMD",10,7,3,0,1
"FMOD",13,6,7,0,1
"MUC12",13,12,1,0,1
"B4GALNT1",7,3,4,0,1
"B4GALNT3",3,1,2,0,1
"MGAT5",5,4,1,0,1
"PRDM1",2,1,1,0,1
"BAG3",6,5,1,0,1
"RELB",7,1,6,0,1
"CEBPD",11,9,2,0,1
"HIST1H2BK",19,11,8,0,1
"BEGAIN",4,3,1,0,1
"DCTN1",28,14,14,0,1
"DYNC1H1",20,12,8,0,1
"DYNC1I1",14,7,7,0,1
"LAMA3",17,8,9,0,1
"SHH",18,10,8,0,1
"BSCL2",6,2,4,0,1
"BSG",4,1,3,0,1
"UNC13A",19,18,1,0,1
"BST2",10,1,9,0,1
"BUB1",45,18,27,0,1
"SKA3",13,6,7,0,1
"BVES",4,1,3,0,1
"TOMM7",8,3,5,0,1
"MS4A6A",7,6,1,0,1
"C1QB",17,7,10,0,1
"YPEL4",2,1,1,0,1
"CDK2",26,6,20,0,1
"CTTN",26,17,9,0,1
"CACNA2D2",25,24,1,0,1
"CACNA1C",48,11,37,0,1
"CALM1",31,10,21,0,1
"KCND2",14,7,7,0,1
"KCNMA1",13,4,9,0,1
"CAMK2G",17,7,10,0,1
"GRIP1",17,11,6,0,1
"CALB2",10,5,5,0,1
"VIP",12,7,5,0,1
"RET",16,10,6,0,1
"MMP9",30,19,11,0,1
"CANX",22,5,17,0,1
"GABRE",4,2,2,0,1
"GSDMD",7,6,1,0,1
"COL4A2",16,7,9,0,1
"NLRC4",10,7,3,0,1
"CYBB",15,10,5,0,1
"DUOX1",7,4,3,0,1
"NOX4",5,2,3,0,1
"FCER1G",22,3,19,0,1
"CCDC96",2,1,1,0,1
"MYCBPAP",2,1,1,0,1
"CCR1",21,7,14,0,1
"CCL2",28,3,25,0,1
"IL15",15,6,9,0,1
"IL18",21,6,15,0,1
"MMP1",11,5,6,0,1
"DRC1",13,4,9,0,1
"FCGR3A",33,19,14,0,1
"STK39",4,3,1,0,1
"CD300C",10,7,3,0,1
"MAP1LC3C",5,3,2,0,1
"KIT",30,6,24,0,1
"CDC5L",7,1,6,0,1
"GFRA1",10,6,4,0,1
"MYO7A",7,6,1,0,1
"PKP3",7,3,4,0,1
"H2AFJ",8,6,2,0,1
"FBXW7",6,4,2,0,1
"GJA1",25,10,15,0,1
"CDKL5",9,5,4,0,1
"CDR2L",2,1,1,0,1
"CDS1",10,4,6,0,1
"PLD1",16,10,6,0,1
"GATA4",19,9,10,0,1
"CEL",4,3,1,0,1
"VANGL1",7,5,2,0,1
"VANGL2",11,5,6,0,1
"CENPH",9,4,5,0,1
"OIP5",26,2,24,0,1
"SGPP2",10,4,6,0,1
"CERS4",10,1,9,0,1
"UGT8",4,2,2,0,1
"WDR90",4,1,3,0,1
"MARVELD2",4,2,2,0,1
"IGF1",42,23,19,0,1
"CHMP4C",8,4,4,0,1
"MAP1LC3A",8,6,2,0,1
"PAK3",18,12,6,0,1
"CIR1",3,2,1,0,1
"GAMT",3,2,1,0,1
"F11R",11,5,6,0,1
"KLC2",14,9,5,0,1
"ENTPD3",8,3,5,0,1
"RSAD2",16,13,3,0,1
"ZDHHC13",3,2,1,0,1
"P4HA2",10,8,2,0,1
"COL17A1",3,1,2,0,1
"COLGALT2",4,2,2,0,1
"COX17",6,2,4,0,1
"CPA2",3,1,2,0,1
"TPSAB1",4,3,1,0,1
"LCA5",4,3,1,0,1
"CRH",17,2,15,0,1
"TAC1",17,6,11,0,1
"IL7R",17,7,10,0,1
"CSTA",5,2,3,0,1
"IGF2",14,11,3,0,1
"POR",11,9,2,0,1
"NGB",3,1,2,0,1
"CYP11B1",12,3,9,0,1
"GPER1",4,3,1,0,1
"FDX1",9,1,8,0,1
"GPC1",22,4,18,0,1
"LUM",16,4,12,0,1
"SDC3",25,13,12,0,1
"DLC1",4,1,3,0,1
"NLGN1",14,11,3,0,1
"DLL4",9,2,7,0,1
"FLT1",24,8,16,0,1
"NOTCH3",15,5,10,0,1
"MSX2",4,1,3,0,1
"HSPA13",7,1,6,0,1
"FGR",21,13,8,0,1
"ELMO3",3,2,1,0,1
"NTRK2",20,8,12,0,1
"DRD2",14,10,4,0,1
"DTNB",5,2,3,0,1
"DYNLRB1",4,1,3,0,1
"RPL38",6,3,3,0,1
"ENKUR",3,1,2,0,1
"ENTPD5",7,5,2,0,1
"FGFR4",17,4,13,0,1
"NEURL1",4,3,1,0,1
"PPL",8,4,4,0,1
"SERPINA5",6,5,1,0,1
"GPANK1",2,1,1,0,1
"ITGA2",35,10,25,0,1
"FLRT3",4,2,2,0,1
"GATA3",10,7,3,0,1
"GATA6",8,2,6,0,1
"NR5A1",9,4,5,0,1
"FOXN4",2,1,1,0,1
"FUT9",8,1,7,0,1
"LRP5",23,9,14,0,1
"HAND2",9,5,4,0,1
"WFIKKN2",2,1,1,0,1
"LPCAT4",12,4,8,0,1
"MTHFD2",3,2,1,0,1
"GNAO1",32,6,26,0,1
"GLP1R",8,4,4,0,1
"RGS17",10,5,5,0,1
"SLC9A3R1",18,2,16,0,1
"GPD2",10,4,6,0,1
"GPR137C",2,1,1,0,1
"GRAMD1B",2,1,1,0,1
"UGDH",3,2,1,0,1
"LCN2",8,5,3,0,1
"HOXA5",5,1,4,0,1
"HOXC6",6,3,3,0,1
"HS6ST1",8,1,7,0,1
"PAPPA",3,1,2,0,1
"IL17RD",4,1,3,0,1
"IL33",6,3,3,0,1
"MTM1",4,2,2,0,1
"NOD2",11,6,5,0,1
"SLC40A1",13,2,11,0,1
"ISL2",3,1,2,0,1
"JAM3",14,5,9,0,1
"KBTBD7",3,2,1,0,1
"KCNAB1",17,15,2,0,1
"KCNAB2",17,11,6,0,1
"KCNB1",18,13,5,0,1
"KCNC1",16,3,13,0,1
"KCNH5",17,5,12,0,1
"KCNK12",5,2,3,0,1
"KCTD3",2,1,1,0,1
"KIFAP3",13,2,11,0,1
"NCF2",15,5,10,0,1
"NPHS1",7,6,1,0,1
"SSR4",5,2,3,0,1
"NTN4",5,3,2,0,1
"MBOAT7",7,2,5,0,1
"LGALS3",23,1,22,0,1
"NRSN1",2,1,1,0,1
"TUBA1A",22,6,16,0,1
"SNRPD1",18,6,12,0,1
"SNRPF",16,5,11,0,1
"OPN3",2,1,1,0,1
"RXRA",13,8,5,0,1
"MKNK1",2,1,1,0,1
"MYL9",9,2,7,0,1
"USH1G",3,2,1,0,1
"SYTL1",3,2,1,0,1
"UNC80",3,2,1,0,1
"NAT9",3,1,2,0,1
"POU3F2",5,1,4,0,1
"SLC12A5",6,4,2,0,1
"PACRG",3,1,2,0,1
"WT1",8,2,6,0,1
"PLS1",3,1,2,0,1
"PLB1",8,2,6,0,1
"PLXNB1",6,4,2,0,1
"PLXNC1",6,1,5,0,1
"TACR3",4,1,3,0,1
"PTGS1",10,3,7,0,1
"PTPN14",4,1,3,0,1
"RPH3A",6,5,1,0,1
"RALGDS",5,2,3,0,1
"RAET1G",2,1,1,0,1
"RD3",4,1,3,0,1
"RSL24D1",8,1,7,0,1
"UTP14C",3,2,1,0,1
"SHROOM3",2,1,1,0,1
"SV2B",3,2,1,0,1
"TMED5",7,5,2,0,1
"TMOD1",8,1,7,0,1
"TSSK4",4,1,3,0,1
"ZNF521",3,1,2,0,1
