"Name","K","Kin","Kout","TypeI","TypeII"
"PDZK1",6,5,1,0,1
"ALB",34,16,18,0,1
"KCNJ11",8,3,5,0,1
"PRKACB",49,37,12,0,1
"LYPLA1",6,4,2,0,1
"NRAS",70,42,28,0,1
"ABTB1",2,1,1,0,1
"SLC4A1",2,1,1,0,1
"HMGCS1",21,13,8,0,1
"HSPA9",48,23,25,0,1
"ACBD3",6,4,2,0,1
"EPRS",55,36,19,0,1
"PHGDH",20,11,9,0,1
"PSEN1",30,16,14,0,1
"FH",25,13,12,0,1
"MDH2",31,15,16,0,1
"SCD",16,11,5,0,1
"SDHB",40,34,6,0,1
"CYCS",43,12,31,0,1
"HSPD1",40,34,6,0,1
"NDUFS1",25,23,2,0,1
"OGDHL",12,7,5,0,1
"AMACR",16,11,5,0,1
"ECI2",21,14,7,0,1
"ACSL5",6,3,3,0,1
"KLK4",6,1,5,0,1
"DDX4",3,2,1,0,1
"CEL",10,8,2,0,1
"ACTA1",28,17,11,0,1
"FLNA",21,15,6,0,1
"TNNC2",22,12,10,0,1
"TPM2",25,16,9,0,1
"EEF1A1",58,28,30,0,1
"ACTR2",12,4,8,0,1
"ARF1",42,36,6,0,1
"CDC42",80,61,19,0,1
"ADA",7,5,2,0,1
"WDR43",24,16,8,0,1
"APP",59,17,42,0,1
"CD9",11,10,1,0,1
"DLL1",14,8,6,0,1
"EGF",33,6,27,0,1
"NCSTN",15,7,8,0,1
"NOTCH1",42,15,27,0,1
"UBB",99,25,74,0,1
"ADAM2",3,1,2,0,1
"HSPA5",64,34,30,0,1
"ADAMTS14",24,17,7,0,1
"VEGFA",35,34,1,0,1
"COL5A2",12,11,1,0,1
"COL5A1",13,9,4,0,1
"ADCY3",25,4,21,0,1
"ADCY4",16,6,10,0,1
"GNAI3",47,28,19,0,1
"PDE4A",10,6,4,0,1
"GSTP1",22,17,5,0,1
"GSTM1",11,5,6,0,1
"ADK",19,7,12,0,1
"ADSSL1",12,6,6,0,1
"APRT",17,14,3,0,1
"POMC",33,24,9,0,1
"PRRT2",8,7,1,0,1
"ADRB2",18,4,14,0,1
"BSG",12,8,4,0,1
"GRIA1",26,20,6,0,1
"ASTN1",3,2,1,0,1
"ENO2",17,14,3,0,1
"AP1G2",6,4,2,0,1
"AP1S1",7,3,4,0,1
"GGCT",7,3,4,0,1
"AGER",10,9,1,0,1
"LTB4R",4,2,2,0,1
"MBOAT2",14,6,8,0,1
"CAMK2B",25,19,6,0,1
"EEF2",64,19,45,0,1
"SDS",9,3,6,0,1
"HSPA4",74,37,37,0,1
"TH",13,9,4,0,1
"ALAS2",7,1,6,0,1
"HBB",12,5,7,0,1
"BDNF",35,26,9,0,1
"C4A",13,8,5,0,1
"CD19",30,27,3,0,1
"CYP3A4",13,3,10,0,1
"SERPINC1",12,11,1,0,1
"CYP4A11",13,8,5,0,1
"AMT",8,1,7,0,1
"ALDH3B2",10,2,8,0,1
"ALG1",9,2,7,0,1
"DPM3",9,4,5,0,1
"GMDS",4,3,1,0,1
"GANAB",12,9,3,0,1
"CYP11A1",11,3,8,0,1
"GNRH1",5,3,2,0,1
"COL4A5",9,4,5,0,1
"AMPH",11,5,6,0,1
"DNM1",22,15,7,0,1
"SGIP1",9,6,3,0,1
"NTRK1",28,22,6,0,1
"ANK2",14,8,6,0,1
"ITPR2",15,10,5,0,1
"TCAP",28,8,20,0,1
"MYPN",5,2,3,0,1
"VCP",39,28,11,0,1
"AURKB",113,54,59,0,1
"CDC20",110,75,35,0,1
"CDK1",147,118,29,0,1
"DIAPH3",15,12,3,0,1
"MYL9",19,6,13,0,1
"UBE2C",91,49,42,0,1
"ZWINT",78,54,24,0,1
"GPHN",9,7,2,0,1
"REPS2",7,3,4,0,1
"GLB1",21,9,12,0,1
"NGF",32,14,18,0,1
"CRP",13,4,9,0,1
"HP",22,11,11,0,1
"HPX",7,2,5,0,1
"NOS3",21,7,14,0,1
"RBP4",7,5,2,0,1
"APOD",3,2,1,0,1
"COX5A",36,17,19,0,1
"FYN",63,26,37,0,1
"HSP90AA1",105,61,44,0,1
"MAPT",31,18,13,0,1
"PDIA3",30,12,18,0,1
"SFTPC",11,6,5,0,1
"SYT2",15,10,5,0,1
"AQP11",3,2,1,0,1
"AQP7",3,2,1,0,1
"PLIN1",10,4,6,0,1
"SUMO1",43,33,10,0,1
"ARF4",21,10,11,0,1
"COPG1",19,9,10,0,1
"SURF4",26,21,5,0,1
"TMED10",47,17,30,0,1
"ITGA10",13,9,4,0,1
"NME1",25,7,18,0,1
"RAC3",27,10,17,0,1
"NEDD4L",12,10,2,0,1
"SUMF2",3,2,1,0,1
"LMNB1",22,5,17,0,1
"FEN1",69,34,35,0,1
"HIST1H4J",32,12,20,0,1
"RRM1",51,19,32,0,1
"MUC4",19,15,4,0,1
"CKS2",53,37,16,0,1
"KCNJ5",7,5,2,0,1
"ATP2A1",14,6,8,0,1
"COX7A2",20,17,3,0,1
"EEF1G",54,16,38,0,1
"P4HB",38,20,18,0,1
"COX4I2",21,18,3,0,1
"UQCR10",32,18,14,0,1
"UBE2N",32,9,23,0,1
"CASC5",39,22,17,0,1
"PPP1CA",34,17,17,0,1
"SCARF1",8,2,6,0,1
"CSPG5",8,6,2,0,1
"GPC2",8,3,5,0,1
"MUC21",15,9,6,0,1
"LYN",53,44,9,0,1
"BCAN",11,7,4,0,1
"NFASC",12,6,6,0,1
"BCL6",12,6,6,0,1
"PRDM8",2,1,1,0,1
"DYNC1H1",23,13,10,0,1
"BIN3",2,1,1,0,1
"FGR",22,13,9,0,1
"LAT",13,10,3,0,1
"BLM",48,22,26,0,1
"RAD52",31,20,11,0,1
"RPA4",8,3,5,0,1
"IHH",11,4,7,0,1
"NOG",10,5,5,0,1
"CLSPN",30,14,16,0,1
"RMI1",20,9,11,0,1
"BYSL",30,3,27,0,1
"DKC1",24,16,8,0,1
"GNL3L",20,10,10,0,1
"DHCR7",17,13,4,0,1
"C1GALT1C1",15,5,10,0,1
"GCNT1",9,6,3,0,1
"SLC39A9",10,4,6,0,1
"DDX39B",21,15,6,0,1
"CD40",29,17,12,0,1
"CA9",5,3,2,0,1
"CALML5",9,8,1,0,1
"CAV3",26,13,13,0,1
"KCNE1",9,5,4,0,1
"PPP1CB",24,19,5,0,1
"MMP9",29,25,4,0,1
"KSR1",10,9,1,0,1
"ITIH4",11,5,6,0,1
"PDIA4",19,7,12,0,1
"RAB10",13,5,8,0,1
"EVPL",7,3,4,0,1
"TRH",6,2,4,0,1
"LDB3",19,14,5,0,1
"MYCBPAP",5,3,2,0,1
"WDR90",8,1,7,0,1
"RPL15",66,22,44,0,1
"SEC61G",47,33,14,0,1
"CX3CR1",13,8,5,0,1
"CXCL9",21,15,6,0,1
"CXCR3",19,14,5,0,1
"DPP4",10,5,5,0,1
"TERT",18,6,12,0,1
"CCNG2",6,3,3,0,1
"PTK6",5,4,1,0,1
"CXCL14",7,5,2,0,1
"CCT4",44,33,11,0,1
"ILF2",17,10,7,0,1
"TCP1",44,21,23,0,1
"CD3G",16,13,3,0,1
"HLA-DRA",23,13,10,0,1
"PLCE1",10,6,4,0,1
"TRAF1",12,6,6,0,1
"ENG",13,10,3,0,1
"CLDN7",9,6,3,0,1
"DSP",9,6,3,0,1
"FGFR1",28,23,5,0,1
"GFRA1",11,4,7,0,1
"OCLN",15,6,9,0,1
"RET",10,5,5,0,1
"MYO3A",6,2,4,0,1
"SMAD3",34,7,27,0,1
"HIST3H2A",25,10,15,0,1
"CEP164",8,1,7,0,1
"GBA",19,9,10,0,1
"SPHK1",15,6,9,0,1
"MARVELD2",7,4,3,0,1
"SCG2",4,3,1,0,1
"UTRN",11,7,4,0,1
"COL9A3",5,1,4,0,1
"ENO3",10,4,6,0,1
"DZIP1L",3,2,1,0,1
"TLR9",9,5,4,0,1
"GLDN",3,2,1,0,1
"COG5",7,2,5,0,1
"COL6A1",9,6,3,0,1
"COL9A1",3,1,2,0,1
"COQ7",3,2,1,0,1
"NDUFS6",28,6,22,0,1
"CPSF3",19,4,15,0,1
"DCLRE1A",10,5,5,0,1
"SRSF11",13,8,5,0,1
"CREB3L4",4,1,3,0,1
"CRHR2",4,2,2,0,1
"CRMP1",6,1,5,0,1
"CXCL5",8,2,6,0,1
"LEP",13,6,7,0,1
"EIF4B",14,12,2,0,1
"RNF20",9,6,3,0,1
"LGMN",11,8,3,0,1
"ISG15",17,14,3,0,1
"OAS2",15,9,6,0,1
"DUOX1",6,2,4,0,1
"NOX1",10,7,3,0,1
"TXN",17,11,6,0,1
"CYP2D6",5,4,1,0,1
"DHCR24",14,13,1,0,1
"SSR3",26,9,17,0,1
"DZIP1",3,1,2,0,1
"FJX1",6,2,4,0,1
"DCK",20,3,17,0,1
"RAD23B",20,12,8,0,1
"SIRT7",8,6,2,0,1
"HNRNPF",10,6,4,0,1
"GDI2",17,12,5,0,1
"EBP",5,4,1,0,1
"S100A14",3,1,2,0,1
"LFNG",3,1,2,0,1
"TEX15",6,1,5,0,1
"GNS",8,1,7,0,1
"SLC35F2",2,1,1,0,1
"SYNE3",5,2,3,0,1
"PAX5",6,2,4,0,1
"EFNA4",4,3,1,0,1
"MAP2K1",23,5,18,0,1
"XAF1",14,9,5,0,1
"SOX10",14,6,8,0,1
"EIF2S3",37,1,36,0,1
"EMB",4,1,3,0,1
"SPINT2",5,3,2,0,1
"PLB1",12,6,6,0,1
"RNF5",8,5,3,0,1
"IVL",8,5,3,0,1
"MPP6",4,2,2,0,1
"F10",5,3,2,0,1
"NAAA",4,2,2,0,1
"SOWAHB",3,2,1,0,1
"NEIL1",3,2,1,0,1
"PLXNA2",9,5,4,0,1
"PDGFRA",21,2,19,0,1
"PHYH",11,1,10,0,1
"TRPC3",10,6,4,0,1
"FLG",5,4,1,0,1
"PNISR",12,6,6,0,1
"FOXA1",11,1,10,0,1
"GATA3",10,6,4,0,1
"NKX2-2",4,2,2,0,1
"FOXP3",8,3,5,0,1
"FUT1",3,1,2,0,1
"GCNT2",3,2,1,0,1
"FZD5",11,6,5,0,1
"GABBR1",4,3,1,0,1
"PSAP",7,6,1,0,1
"HK2",10,5,5,0,1
"GFPT1",8,4,4,0,1
"PDLIM7",8,3,5,0,1
"GLI3",4,2,2,0,1
"PLCB2",23,5,18,0,1
"TAS1R3",10,6,4,0,1
"KISS1",2,1,1,0,1
"SEC16A",11,4,7,0,1
"VPS35",12,6,6,0,1
"NTRK3",9,3,6,0,1
"OVOL2",2,1,1,0,1
"GTF3C1",4,2,2,0,1
"QPRT",4,3,1,0,1
"HOXD13",3,2,1,0,1
"KAT2A",21,2,19,0,1
"MEIS1",8,1,7,0,1
"HS2ST1",2,1,1,0,1
"IFIH1",20,5,15,0,1
"INPP5B",13,7,6,0,1
"INPP5E",8,2,6,0,1
"TBX5",8,4,4,0,1
"KBTBD12",2,1,1,0,1
"KCNH5",7,5,2,0,1
"SCN4B",17,5,12,0,1
"KLHL3",6,2,4,0,1
"KLHL40",7,3,4,0,1
"TGM4",2,1,1,0,1
"LACTB2",4,1,3,0,1
"NID1",17,7,10,0,1
"NPM1",22,5,17,0,1
"NLGN2",12,4,8,0,1
"TCERG1",5,3,2,0,1
"MPEG1",3,1,2,0,1
"SLC30A5",9,7,2,0,1
"MFSD9",3,1,2,0,1
"MGAT2",3,1,2,0,1
"MINPP1",6,3,3,0,1
"MLKL",6,2,4,0,1
"MRPL15",48,4,44,0,1
"MRPL3",45,7,38,0,1
"MSS51",2,1,1,0,1
"MUC17",13,2,11,0,1
"NDNL2",7,4,3,0,1
"PDXDC1",3,2,1,0,1
"RBFOX1",6,3,3,0,1
"SYNE1",7,3,4,0,1
"SLC26A2",2,1,1,0,1
"PRPF3",10,6,4,0,1
"TUSC5",2,1,1,0,1
"SYN3",10,7,3,0,1
"RDH10",11,1,10,0,1
"SCNN1G",7,3,4,0,1
"SCNN1D",3,2,1,0,1
"WNT2B",9,7,2,0,1
"SLC5A12",2,1,1,0,1
"SLC1A5",3,1,2,0,1
"SLC26A3",5,3,2,0,1
"SLC47A1",3,1,2,0,1
"STX2",7,5,2,0,1
"TPD52",4,2,2,0,1
"TMED5",9,7,2,0,1
"TRMT12",4,2,2,0,1
"TUBB",12,1,11,0,1
