"Name","K","Kin","Kout","TypeI","TypeII"
"CNDP2",14,8,6,0,1
"EPRS",66,42,24,0,1
"IARS2",21,13,8,0,1
"KARS",34,20,14,0,1
"TRPC4",12,9,3,0,1
"ABCA1",15,11,4,0,1
"CDC42",136,107,29,0,1
"TMPRSS6",11,8,3,0,1
"UGT1A1",17,12,5,0,1
"ALB",56,23,33,0,1
"GGCX",10,3,7,0,1
"VKORC1",7,4,3,0,1
"DDB1",39,9,30,0,1
"EEF1G",52,21,31,0,1
"RRM1",62,25,37,0,1
"SNRNP200",21,11,10,0,1
"ATP1B1",11,6,5,0,1
"RAC1",103,52,51,0,1
"ABT1",23,7,16,0,1
"ACBD3",6,3,3,0,1
"NOS3",32,13,19,0,1
"TAC1",11,4,7,0,1
"PKM",50,22,28,0,1
"SDHA",26,12,14,0,1
"AGXT",28,14,14,0,1
"ALDH1A1",13,4,9,0,1
"ATP5B",41,10,31,0,1
"GPI",32,28,4,0,1
"NDUFS1",23,19,4,0,1
"TOMM20",21,17,4,0,1
"ACOX1",37,13,24,0,1
"AMACR",17,14,3,0,1
"MPV17",17,11,6,0,1
"PIPOX",22,10,12,0,1
"BLVRB",5,1,4,0,1
"TNNC2",14,8,6,0,1
"ACTB",154,94,60,0,1
"ACTR2",32,20,12,0,1
"ANXA1",11,10,1,0,1
"B2M",55,51,4,0,1
"CASP8",45,30,15,0,1
"ENAH",12,7,5,0,1
"EZR",36,24,12,0,1
"GRB2",126,94,32,0,1
"ITGB1",121,93,28,0,1
"LMNA",20,15,5,0,1
"MMP9",39,28,11,0,1
"MYO6",22,15,7,0,1
"NCK1",57,50,7,0,1
"NF1",35,28,7,0,1
"PGK1",25,17,8,0,1
"POLE3",42,25,17,0,1
"PRKCA",79,61,18,0,1
"PTGS2",27,21,6,0,1
"SQSTM1",37,29,8,0,1
"XIAP",41,27,14,0,1
"YWHAZ",71,58,13,0,1
"CAPZA2",17,11,6,0,1
"GDI2",22,17,5,0,1
"NCKAP1",19,8,11,0,1
"WIPF2",15,6,9,0,1
"ACVR1",13,2,11,0,1
"BMPR1A",21,14,7,0,1
"HFE2",17,5,12,0,1
"TDGF1",5,3,2,0,1
"APP",83,29,54,0,1
"CDH2",29,5,24,0,1
"COL17A1",11,9,2,0,1
"CTNNA1",49,21,28,0,1
"CTNNB1",181,113,68,0,1
"NCSTN",24,7,17,0,1
"PSEN1",40,21,19,0,1
"PTGFRN",3,2,1,0,1
"CDA",7,6,1,0,1
"COQ5",4,3,1,0,1
"ADCY2",24,10,14,0,1
"GNAI3",60,41,19,0,1
"GNAS",44,31,13,0,1
"PDE1A",10,9,1,0,1
"PDE4D",17,7,10,0,1
"PRKACB",87,63,24,0,1
"PRKAR1A",27,18,9,0,1
"GNAI1",47,22,25,0,1
"PRKAR1B",17,14,3,0,1
"XPO5",13,4,9,0,1
"COMT",19,12,7,0,1
"GSTA1",20,10,10,0,1
"PNPLA4",10,5,5,0,1
"VIP",12,9,3,0,1
"GNAQ",68,10,58,0,1
"ADRB2",22,10,12,0,1
"CHRM1",21,10,11,0,1
"LCK",69,28,41,0,1
"WNT3A",21,8,13,0,1
"AP1G1",20,14,6,0,1
"AP1S1",14,4,10,0,1
"SGIP1",8,5,3,0,1
"AGER",6,5,1,0,1
"PGM1",19,13,6,0,1
"AGMO",5,3,2,0,1
"AGO1",24,16,8,0,1
"GPD2",8,3,5,0,1
"CAMK2D",28,12,16,0,1
"SHMT1",21,11,10,0,1
"EEF2",51,20,31,0,1
"CAV1",65,29,36,0,1
"BCL2L1",50,20,30,0,1
"CASP3",83,40,43,0,1
"TSFM",13,5,8,0,1
"AKAP7",8,5,3,0,1
"AKAP6",7,1,6,0,1
"CBR1",11,2,9,0,1
"GLB1",28,13,15,0,1
"HK2",26,7,19,0,1
"HSD11B2",6,3,3,0,1
"CD34",37,16,21,0,1
"CXCL8",51,19,32,0,1
"HP",21,13,8,0,1
"MB",6,5,1,0,1
"NGF",43,28,15,0,1
"NPHS1",15,13,2,0,1
"PLG",40,19,21,0,1
"PROM1",12,8,4,0,1
"ALDH18A1",23,13,10,0,1
"UGT1A9",14,7,7,0,1
"CYP4A22",18,12,6,0,1
"ALG8",11,5,6,0,1
"PMM2",5,1,4,0,1
"ALOX5",18,7,11,0,1
"INHA",3,1,2,0,1
"PARD3",21,14,7,0,1
"ANXA2",30,19,11,0,1
"TEK",30,22,8,0,1
"ANGPTL3",7,3,4,0,1
"ANK2",19,12,7,0,1
"DCTN4",24,20,4,0,1
"SCN2A",11,7,4,0,1
"GABARAP",27,8,19,0,1
"KCNQ3",9,8,1,0,1
"SEC63",17,12,5,0,1
"AURKB",105,46,59,0,1
"BUB1B",109,30,79,0,1
"CD2AP",20,10,10,0,1
"CDC25C",62,26,36,0,1
"CENPF",81,50,31,0,1
"INCENP",50,38,12,0,1
"PRC1",75,57,18,0,1
"TYMS",79,42,37,0,1
"S100A6",7,3,4,0,1
"ANXA5",29,11,18,0,1
"GPNMB",5,3,2,0,1
"CD28",47,13,34,0,1
"ITGAL",23,11,12,0,1
"ARF6",47,20,27,0,1
"DCTN5",22,5,17,0,1
"FZD5",21,11,10,0,1
"GRIP1",20,11,9,0,1
"KIAA0319",4,2,2,0,1
"UBQLN2",21,8,13,0,1
"ITGB2",57,46,11,0,1
"HBB",10,5,5,0,1
"UNC45B",6,2,4,0,1
"SDC2",50,18,32,0,1
"TREM2",17,10,7,0,1
"VCAM1",27,7,20,0,1
"PLAUR",34,22,12,0,1
"CALR",48,26,22,0,1
"CTSB",29,11,18,0,1
"F11",10,9,1,0,1
"GRIN2A",29,20,9,0,1
"GSK3B",51,25,26,0,1
"PDIA3",33,12,21,0,1
"AQP11",4,3,1,0,1
"AQP3",5,3,2,0,1
"AVPR2",9,5,4,0,1
"RAB11A",27,7,20,0,1
"COPG1",25,12,13,0,1
"GIT1",17,13,4,0,1
"MET",59,28,31,0,1
"RHOT1",12,8,4,0,1
"ATRX",10,3,7,0,1
"RAB6B",12,2,10,0,1
"P2RX7",8,5,3,0,1
"ARL6IP1",3,1,2,0,1
"RTN4",12,5,7,0,1
"ARL6IP5",4,2,2,0,1
"KIF5B",29,11,18,0,1
"MORN5",6,5,1,0,1
"CLOCK",5,3,2,0,1
"CD3G",32,28,4,0,1
"KDSR",12,10,2,0,1
"HIST1H4J",21,9,12,0,1
"RAD51",92,73,19,0,1
"RBBP4",54,44,10,0,1
"DPY30",10,6,4,0,1
"NAT8L",6,5,1,0,1
"KIF20B",32,19,13,0,1
"INTS5",6,3,3,0,1
"RGS16",10,6,4,0,1
"NOG",17,9,8,0,1
"SMARCE1",22,5,17,0,1
"ATG7",26,14,12,0,1
"NBR1",12,10,2,0,1
"RAB7B",11,10,1,0,1
"PAX6",13,9,4,0,1
"ATP1A2",8,5,3,0,1
"PLN",13,6,7,0,1
"ATP6V1B2",23,5,18,0,1
"P4HB",43,21,22,0,1
"RPTOR",30,12,18,0,1
"RRAGC",17,8,9,0,1
"NCAPD2",45,28,17,0,1
"PPP1CC",50,25,25,0,1
"NCL",43,20,23,0,1
"NDC1",31,23,8,0,1
"PPP1CA",54,24,30,0,1
"SCARF1",10,1,9,0,1
"AXIN1",29,4,25,0,1
"LRP5",28,11,17,0,1
"MAP3K1",39,30,9,0,1
"PPP2R1A",62,31,31,0,1
"WNT8B",21,12,9,0,1
"WNT9B",18,7,11,0,1
"JAK1",43,26,17,0,1
"PTPN11",97,46,51,0,1
"NAGA",7,6,1,0,1
"B4GALT1",21,15,6,0,1
"GCNT2",5,2,3,0,1
"MUC21",11,9,2,0,1
"B4GALNT1",10,7,3,0,1
"FUT8",8,5,3,0,1
"BCAN",14,5,9,0,1
"SDC4",34,23,11,0,1
"NRAS",99,65,34,0,1
"NFATC2",11,4,7,0,1
"BBS10",34,25,9,0,1
"FN1",89,54,35,0,1
"PTPRZ1",11,7,4,0,1
"BCKDHB",10,6,4,0,1
"MCCC2",7,5,2,0,1
"KNG1",32,8,24,0,1
"COG5",17,7,10,0,1
"DCTN1",33,16,17,0,1
"MS4A6A",12,11,1,0,1
"FAS",26,16,10,0,1
"TLR3",16,8,8,0,1
"HFE",10,7,3,0,1
"NUP93",36,17,19,0,1
"MAPK11",31,15,16,0,1
"PDGFRB",46,11,35,0,1
"TRPV6",9,4,5,0,1
"TAF7",19,8,11,0,1
"RAD50",32,21,11,0,1
"RAD51C",35,17,18,0,1
"RMI1",30,10,20,0,1
"BSG",14,7,7,0,1
"BSND",7,2,5,0,1
"BST2",11,2,9,0,1
"GP2",6,5,1,0,1
"HLA-B",38,32,6,0,1
"COPS6",25,7,18,0,1
"TSR1",42,12,30,0,1
"DHCR7",11,7,4,0,1
"C1GALT1C1",15,2,13,0,1
"C1QB",22,10,12,0,1
"DLGAP3",7,4,3,0,1
"CA4",3,1,2,0,1
"CACNA2D2",10,9,1,0,1
"CATSPER2",10,7,3,0,1
"CASK",18,13,5,0,1
"EPB41L2",6,3,3,0,1
"CALCA",15,6,9,0,1
"RET",25,14,11,0,1
"CD47",16,9,7,0,1
"SYNCRIP",23,15,8,0,1
"F11R",16,8,8,0,1
"SEC62",12,7,5,0,1
"TOR1A",12,9,3,0,1
"G3BP1",18,14,4,0,1
"DYNC1H1",39,21,18,0,1
"DYNLRB1",16,9,7,0,1
"S100B",12,5,7,0,1
"CNOT7",12,7,5,0,1
"OCLN",22,12,10,0,1
"SPTA1",6,3,3,0,1
"CBLL1",3,2,1,0,1
"NRXN1",12,8,4,0,1
"H2AFV",49,21,28,0,1
"CCDC114",16,3,13,0,1
"CFAP45",3,2,1,0,1
"DNAH8",8,3,5,0,1
"DYX1C1",11,6,5,0,1
"RBM44",4,2,2,0,1
"RPL29",37,27,10,0,1
"HYDIN",5,2,3,0,1
"CCL11",26,11,15,0,1
"CXCR3",29,20,9,0,1
"CCR1",26,12,14,0,1
"IL1B",60,13,47,0,1
"CX3CR1",21,9,12,0,1
"CDK14",10,7,3,0,1
"NUP160",33,25,8,0,1
"NUP43",30,19,11,0,1
"PRKAR2A",32,5,27,0,1
"RCC1",17,11,6,0,1
"CCND1",48,6,42,0,1
"ERBB2",69,18,51,0,1
"PSMD2",49,16,33,0,1
"CD86",50,20,30,0,1
"TUBA1B",26,14,12,0,1
"RUVBL1",51,22,29,0,1
"STRN",16,4,12,0,1
"CHM",20,11,9,0,1
"CHML",21,13,8,0,1
"CD3D",32,9,23,0,1
"CD5",20,6,14,0,1
"PTPN6",49,40,9,0,1
"SPN",15,5,10,0,1
"HLA-DRA",44,29,15,0,1
"NPHS2",9,6,3,0,1
"CD300C",17,8,9,0,1
"IL2RG",27,16,11,0,1
"RGS1",16,10,6,0,1
"CSF1R",42,10,32,0,1
"LGALS9",10,5,5,0,1
"SIRPA",14,10,4,0,1
"CD6",5,2,3,0,1
"TYROBP",53,7,46,0,1
"SH2D1B",6,2,4,0,1
"CNPPD1",4,3,1,0,1
"FTO",7,6,1,0,1
"THADA",6,4,2,0,1
"CDKL5",4,3,1,0,1
"LEF1",17,1,16,0,1
"FZD6",21,14,7,0,1
"MAPRE2",8,4,4,0,1
"CES2",5,3,2,0,1
"MAD1L1",6,4,2,0,1
"CFHR1",2,1,1,0,1
"CFHR3",4,2,2,0,1
"TMOD3",6,1,5,0,1
"PLA2G16",12,7,5,0,1
"CHID1",3,2,1,0,1
"CHL1",14,1,13,0,1
"CHRDL2",2,1,1,0,1
"CHRNB2",5,3,2,0,1
"LAMA3",29,16,13,0,1
"GRM5",17,5,12,0,1
"CSPG4",16,8,8,0,1
"DIS3",12,8,4,0,1
"MYOZ1",9,4,5,0,1
"CNTFR",3,2,1,0,1
"CLDN4",7,6,1,0,1
"TRPM6",5,3,2,0,1
"LLGL1",7,3,4,0,1
"PTP4A1",9,5,4,0,1
"P4HA1",22,3,19,0,1
"LUM",20,6,14,0,1
"PLOD2",11,4,7,0,1
"COL6A3",14,7,7,0,1
"MIA3",5,2,3,0,1
"RRAS2",16,4,12,0,1
"CPPED1",5,2,3,0,1
"CRB3",4,2,2,0,1
"PITPNA",5,4,1,0,1
"FCER1G",39,7,32,0,1
"PDGFA",21,15,6,0,1
"SOCS1",15,8,7,0,1
"KIF5C",13,10,3,0,1
"ZCRB1",10,2,8,0,1
"S100A8",11,4,7,0,1
"SOAT1",5,3,2,0,1
"KL",17,12,5,0,1
"PTGS1",13,7,6,0,1
"PLA2G1B",9,4,5,0,1
"HOMER1",8,1,7,0,1
"ENTPD3",20,6,14,0,1
"DDRGK1",3,1,2,0,1
"SRPRB",15,12,3,0,1
"GLE1",15,8,7,0,1
"DHRS2",2,1,1,0,1
"EIF4A1",36,7,29,0,1
"STAU1",7,5,2,0,1
"DKK1",12,8,4,0,1
"ETFB",6,5,1,0,1
"JAG1",13,2,11,0,1
"FES",9,3,6,0,1
"TMEM43",5,2,3,0,1
"TCTEX1D2",13,4,9,0,1
"TCTE3",5,3,2,0,1
"IKZF3",9,2,7,0,1
"EDA",3,2,1,0,1
"PABPC1",35,8,27,0,1
"KIT",44,11,33,0,1
"PIK3CB",47,18,29,0,1
"PPME1",4,3,1,0,1
"PFKM",19,9,10,0,1
"SELT",13,11,2,0,1
"RHOB",16,4,12,0,1
"UNC13A",6,4,2,0,1
"PRDX4",12,6,6,0,1
"GOLT1A",3,2,1,0,1
"SUFU",32,14,18,0,1
"EXOC4",18,4,14,0,1
"RAB8B",12,3,9,0,1
"HS2ST1",18,8,10,0,1
"GNA15",14,3,11,0,1
"MAP9",2,1,1,0,1
"NLRP3",15,5,10,0,1
"MFAP5",6,3,3,0,1
"NCR3",7,3,4,0,1
"TMX4",7,2,5,0,1
"KATNB1",3,2,1,0,1
"SLC46A1",3,2,1,0,1
"ITGA10",14,7,7,0,1
"PROX1",3,1,2,0,1
"WFIKKN1",3,2,1,0,1
"HEXA",13,5,8,0,1
"HEXB",14,3,11,0,1
"GGT6",13,6,7,0,1
"GPX4",17,8,9,0,1
"TMEM144",2,1,1,0,1
"GNPTG",4,1,3,0,1
"RGS7BP",6,2,4,0,1
"HPD",4,2,2,0,1
"PTPRD",5,3,2,0,1
"POLR2J",14,5,9,0,1
"OLFM2",3,1,2,0,1
"HBD",7,6,1,0,1
"HBG2",5,4,1,0,1
"SMYD2",4,3,1,0,1
"MEIS1",12,2,10,0,1
"HSD11B1",11,5,6,0,1
"ORMDL3",6,4,2,0,1
"MMP1",15,7,8,0,1
"ITFG1",3,1,2,0,1
"NOTCH2",20,2,18,0,1
"KBTBD7",2,1,1,0,1
"KCNJ4",6,3,3,0,1
"SPINK5",3,1,2,0,1
"LACTB2",4,2,2,0,1
"PDE12",3,2,1,0,1
"TLL2",2,1,1,0,1
"LIPC",9,3,6,0,1
"LDOC1L",2,1,1,0,1
"PNISR",7,2,5,0,1
"LGR5",7,2,5,0,1
"PUM2",8,3,5,0,1
"LNPEP",16,2,14,0,1
"LOXHD1",4,3,1,0,1
"LRPAP1",13,11,2,0,1
"NTNG1",2,1,1,0,1
"LYZ",2,1,1,0,1
"MARVELD2",6,2,4,0,1
"MCU",5,4,1,0,1
"MGRN1",6,2,4,0,1
"MEOX2",2,1,1,0,1
"PIWIL2",5,2,3,0,1
"PCDH19",3,1,2,0,1
"TRPV5",13,3,10,0,1
"NMNAT3",5,1,4,0,1
"RBFOX1",2,1,1,0,1
"NPC1",6,1,5,0,1
"NPEPPS",3,1,2,0,1
"ORAI2",4,2,2,0,1
"SLC1A1",3,2,1,0,1
"TREM1",9,1,8,0,1
"PGPEP1",2,1,1,0,1
"USP9X",7,2,5,0,1
"RAMP3",10,1,9,0,1
"YIPF5",6,2,4,0,1
"WT1",8,1,7,0,1
"SLC5A12",4,3,1,0,1
"SLC47A1",5,1,4,0,1
